facebook.com	reject	agari,self
yahoo.com	reject	self:yahoo,self
taobao.com	quarantine	self:alibaba
amazon.com	quarantine	self:amazon
google.com	quarantine	self:google
youtube.com	quarantine	self:google
twitter.com	reject	agari
live.com	nil
linkedin.com	reject	agari,returnpath
google.co.in	reject	self:google
wikipedia.org	none	self
ebay.com	none	agari,returnpath
google.co.jp	reject	self:google
tmall.com	quarantine	self:alibaba
blogspot.com	none	self:google
google.de	reject	self:google
yahoo.co.jp	nil
t.co	reject	agari
yandex.ru	none	returnpath,self
baidu.com	nil
qq.com	none	self
bing.com	nil
google.co.uk	reject	self:google
msn.com	nil
vk.com	nil
amazon.co.jp	quarantine	self:amazon
instagram.com	reject	agari
google.fr	reject	self:google
reddit.com	nil
google.com.br	reject	self:google
mail.ru	none	agari,self,returnpath
aliexpress.com	none	self:alibaba
wordpress.com	quarantine	dmarcian
hao123.com	nil
pinterest.com	reject	agari
gmail.com	none	self:google
sohu.com	nil
paypal.com	reject	agari,self
tumblr.com	nil
ask.com	nil
onclickads.net	nil
imgur.com	none	self
google.it	reject	self:google
xvideos.com	invalid
microsoft.com	none	agari
apple.com	none	agari
google.es	reject	self:google
googleadservices.com	none	self:google
alibaba.com	none	self:alibaba
amazon.de	quarantine	self:amazon
netflix.com	reject	agari,netcraft
fc2.com	nil
imdb.com	nil
weibo.com	nil
craigslist.org	none	dmarcian
google.ca	reject	self:google
google.com.mx	reject	self:google
360.cn	nil
stackoverflow.com	nil
xhamster.com	nil
pornhub.com	nil
adcash.com	nil
amazon.co.uk	quarantine	self:amazon
google.com.hk	reject	self:google
gmw.cn	nil
ok.ru	nil
google.com.tr	reject	self:google
tianya.cn	nil
ebay.de	none	agari,returnpath
naver.com	nil
sina.com.cn	nil
rakuten.co.jp	none	self
bbc.co.uk	nil
google.co.id	none	self:google
people.com.cn	nil
diply.com	invalid
google.pl	reject	self:google
google.com.au	reject	self:google
outbrain.com	nil
xinhuanet.com	nil
soso.com	nil
cntv.cn	nil
adobe.com	none	agari
dropbox.com	reject	agari,self
flipkart.com	nil
amazon.in	quarantine	self:amazon
pixnet.net	nil
nicovideo.jp	nil
googleusercontent.com	none	self:google
cnn.com	nil
amazon.cn	quarantine	self:amazon
google.co.kr	reject	self:google
chinadaily.com.cn	nil
alipay.com	quarantine	self:alibaba
booking.com	reject	agari,returnpath,self
dailymotion.com	nil
github.com	none	self
163.com	nil
directrev.com	nil
jd.com	nil
ebay.co.uk	none	agari,returnpath
wikia.com	invalid
google.com.tw	none	self:google
youku.com	nil
detail.tmall.com	nil
indiatimes.com	nil
huffingtonpost.com	nil
nytimes.com	none	self
bycontext.com	nil
espn.go.com	nil
blogger.com	none	self:google
google.com.sa	none	self:google
google.nl	reject	self:google
xnxx.com	nil
chase.com	reject	agari
dailymail.co.uk	nil
google.co.th	none	self:google
livedoor.jp	nil
buzzfeed.com	nil
google.com.eg	none	self:google
china.com	nil
youradexchange.com	nil
tudou.com	nil
google.com.ar	reject	self:google
uol.com.br	nil
blogspot.in	none	self:google
ameblo.jp	nil
popads.net	nil
google.com.pk	reject	self:google
bankofamerica.com	none	self
livedoor.com	nil
go.com	nil
pconline.com.cn	nil
globo.com	nil
redtube.com	nil
walmart.com	nil
bongacams.com	nil
dmm.co.jp	nil
amazon.fr	quarantine	self:amazon
kickass.to	nil
coccoc.com	nil
douban.com	nil
slideshare.net	none	agari
flickr.com	none	self:yahoo
etsy.com	none	returnpath,self
aol.com	reject	agari
quora.com	quarantine	dmarcian
ettoday.net	nil
sogou.com	nil
about.com	none	agari
weather.com	nil
daum.net	nil
bbc.com	nil
theguardian.com	nil
twitch.tv	nil
yelp.com	none	self
indeed.com	quarantine	self
youporn.com	nil
kat.cr	nil
cnet.com	nil
amazonaws.com	nil
stackexchange.com	nil
loading-delivery1.com	nil
google.co.za	reject	self:google
warmportrait.com	nil
snapdeal.com	nil
naver.jp	nil
adf.ly	nil
wellsfargo.com	none	returnpath
zillow.com	nil
deviantart.com	nil
google.co.ve	none	self:google
google.gr	reject	self:google
mystart.com	nil
microsoftonline.com	none	agari
amazon.it	quarantine	self:amazon
vimeo.com	nil
forbes.com	nil
soundcloud.com	nil
godaddy.com	none	self
wikihow.com	nil
tubecup.com	nil
ilividnewtab.com	nil
office365.com	nil
bp.blogspot.com	nil
wordpress.org	invalid
leboncoin.fr	nil
google.com.ua	reject	self:google
tripadvisor.com	nil
feedly.com	nil
themeforest.net	nil
livejournal.com	nil
doublepimp.com	nil
foxnews.com	nil
onet.pl	nil
goo.ne.jp	nil
china.com.cn	nil
kakaku.com	nil
salesforce.com	none	agari
abs-cbnnews.com	nil
avito.ru	nil
ikea.com	nil
ifeng.com	nil
vice.com	nil
homedepot.com	nil
files.wordpress.com	nil
xuite.net	invalid
mozilla.org	nil
w3schools.com	nil
bestbuy.com	nil
wikimedia.org	none	self
nih.gov	nil
businessinsider.com	nil
pixiv.net	nil
google.be	reject	self:google
stamplive.com	nil
reference.com	nil
taboola.com	quarantine	
mediafire.com	nil
google.com.co	none	self:google
espncricinfo.com	nil
zol.com.cn	nil
target.com	none	agari
9gag.com	nil
ups.com	reject	agari
popcash.net	nil
google.ro	reject	self:google
gfycat.com	nil
telegraph.co.uk	nil
google.com.sg	none	self:google
doorblog.jp	nil
pclady.com.cn	nil
gamer.com.tw	nil
web.de	nil
zhihu.com	nil
comcast.net	none	self
avg.com	none	self
softonic.com	nil
bitauto.com	nil
addthis.com	none	self
secureserver.net	nil
washingtonpost.com	nil
reimageplus.com	nil
wix.com	none	returnpath,unknown:dmarc_agg@vali.email,self,unknown:dmarc_2d429365_afrf@vali.email
archive.org	nil
youm7.com	nil
mydomainadvisor.com	nil
blogspot.com.br	none	self:google
americanexpress.com	reject	returnpath
google.at	reject	self:google
xywy.com	nil
google.com.ph	reject	self:google
google.com.ng	none	self:google
gmx.net	nil
wow.com	nil
google.cn	reject	self:google
usps.com	none	agari
orange.fr	nil
sourceforge.net	nil
badoo.com	none	returnpath,agari,self
shutterstock.com	nil
google.se	reject	self:google
office.com	nil
quikr.com	nil
amazon.es	quarantine	self:amazon
github.io	nil
google.pt	reject	self:google
livejasmin.com	nil
thepiratebay.se	nil
adplxmd.com	nil
ndtv.com	nil
wordreference.com	nil
weebly.com	nil
mercadolivre.com.br	reject	
dmm.com	nil
steamcommunity.com	nil
caijing.com.cn	nil
pandora.com	none	dmarcian
ask.fm	nil
youth.cn	nil
blogfa.com	nil
goodreads.com	nil
groupon.com	none	agari,self
bild.de	nil
wp.pl	nil
mailchimp.com	nil
whatsapp.com	reject	
icicibank.com	none	agari,self
answers.com	nil
hdfcbank.com	none	returnpath
google.com.pe	reject	self:google
ign.com	none	self
kaskus.co.id	nil
skype.com	nil
akamaihd.net	nil
google.ae	reject	self:google
force.com	reject	agari
webmd.com	nil
mashable.com	quarantine	self
google.ch	reject	self:google
pchome.net	nil
hulu.com	nil
capitalone.com	none	agari
smzdm.com	nil
uptodown.com	nil
google.ru	reject	self:google
teepr.com	nil
rambler.ru	nil
t-online.de	nil
stumbleupon.com	none	postmarkapp,self
udn.com	nil
bomb01.com	nil
mama.cn	nil
bilibili.com	nil
seznam.cz	nil
usatoday.com	nil
spiegel.de	nil
1688.com	nil
1905.com	nil
hp.com	nil
fedex.com	reject	returnpath,self
bleacherreport.com	invalid
tube8.com	nil
jabong.com	nil
google.cl	none	self:google
hurriyet.com.tr	nil
hootsuite.com	nil
mobile01.com	nil
dell.com	none	self:dell
engadget.com	nil
rediff.com	nil
39.net	nil
accuweather.com	nil
theladbible.com	nil
speedtest.net	nil
mlb.com	nil
webssearches.com	nil
extratorrent.cc	nil
chinatimes.com	nil
media.tumblr.com	nil
google.com.bd	none	self:google
google.no	none	self:google
google.dz	none	self:google
amazon.ca	quarantine	self:amazon
spotify.com	none	dmarcian,self
wsj.com	nil
slickdeals.net	nil
life.com.tw	nil
thesaurus.com	nil
bloomberg.com	invalid
google.cz	none	self:google
varzesh3.com	nil
onlinesbi.com	nil
2ch.net	nil
b5m.com	nil
kickstarter.com	nil
samsung.com	nil
eastmoney.com	nil
bet365.com	quarantine	self
fbcdn.net	nil
ijreview.com	nil
verizonwireless.com	reject	returnpath
nba.com	nil
gsmarena.com	nil
haosou.com	nil
ppomppu.co.kr	nil
babytree.com	nil
newegg.com	reject	self
liveinternet.ru	nil
rutracker.org	nil
zendesk.com	quarantine	dmarcian
google.ie	reject	self:google
ebay.in	none	agari,returnpath
kompas.com	nil
time.com	nil
lady8844.com	nil
thefreedictionary.com	nil
milliyet.com.tr	nil
sahibinden.com	nil
flirchi.com	none	
marca.com	nil
iqiyi.com	nil
ck101.com	nil
twimg.com	nil
google.co.il	reject	self:google
4shared.com	nil
libero.it	quarantine	self,returnpath
liputan6.com	nil
livedoor.biz	nil
photobucket.com	nil
allegro.pl	nil
infusionsoft.com	none	self
blog.jp	nil
lowes.com	nil
ltn.com.tw	nil
lifehacker.com	invalid
macys.com	nil
tistory.com	nil
chaturbate.com	nil
ero-advertising.com	nil
ameba.jp	nil
evernote.com	reject	self
att.com	none	agari,returnpath
tlbb8.com	invalid
disqus.com	none	postmarkapp
webtretho.com	nil
adidas.tmall.com	nil
goal.com	nil
eksisozluk.com	nil
expedia.com	none	returnpath
reuters.com	nil
csdn.net	nil
meetup.com	nil
nyaa.se	invalid
taleo.net	none	self
mega.co.nz	nil
ce.cn	nil
ebay.com.au	none	agari,returnpath
elpais.com	nil
torrentz.eu	nil
oracle.com	nil
justdial.com	nil
yandex.ua	nil
citibank.com	none	agari,self
watsons.tmall.com	nil
naukri.com	nil
bhaskar.com	nil
ink361.com	none	
detik.com	nil
ebay.it	none	agari,returnpath
olx.in	nil
bestadbid.com	nil
xda-developers.com	nil
privatehomeclips.com	nil
scribd.com	nil
repubblica.it	nil
xfinity.com	nil
uploaded.net	nil
gizmodo.com	invalid
32d1d3b9c.se	nil
likes.com	invalid
free.fr	nil
theadgateway.com	nil
agoda.com	nil
gmarket.co.kr	nil
fiverr.com	nil
irctc.co.in	nil
trello.com	none	dmarcian,self,postmarkapp
gap.com	none	agari,returnpath
gome.com.cn	nil
paytm.com	nil
kouclo.com	nil
sberbank.ru	nil
gameforge.com	nil
souq.com	nil
icloud.com	none	agari
blogimg.jp	nil
list-manage.com	invalid
haiwainet.cn	nil
chaoshi.tmall.com	nil
nordstrom.com	nil
autohome.com.cn	none	self:netease
kooora.com	nil
steampowered.com	nil
hupu.com	nil
trackingclick.net	nil
exoclick.com	nil
google.fi	reject	self:google
kohls.com	nil
mobile.de	nil
google.com.vn	reject	self:google
xe.com	nil
theverge.com	nil
staticwebdom.com	nil
asos.com	nil
styletv.com.cn	nil
baike.com	nil
google.dk	reject	self:google
hotels.com	nil
ashleyrnadison.com	nil
trulia.com	none	returnpath
battle.net	reject	returnpath
doubleclick.net	nil
realtor.com	nil
shopclues.com	nil
google.hu	reject	self:google
airbnb.com	reject	self
impress.co.jp	nil
kijiji.ca	invalid
wunderground.com	nil
mercadolibre.com.ar	reject	
drseks.com	invalid
eyny.com	nil
youboy.com	nil
elmundo.es	nil
zippyshare.com	invalid
corriere.it	nil
kinopoisk.ru	nil
independent.co.uk	nil
rt.com	nil
google.sk	reject	self:google
onedio.com	nil
intuit.com	nil
savefrom.net	nil
hm.com	none	returnpath
buzzfil.net	nil
jqw.com	nil
subscene.com	nil
cloudfront.net	nil
rbc.ru	invalid
chinaz.com	nil
surveymonkey.com	none	returnpath,self
google.com.my	reject	self:google
6pm.com	nil
azlyrics.com	nil
eastday.com	nil
techcrunch.com	nil
gazeta.pl	nil
beeg.com	nil
vipcpms.com	nil
it168.com	nil
issuu.com	nil
kayak.com	none	self
eonline.com	nil
duckduckgo.com	nil
wikiwiki.jp	nil
seesaa.net	nil
retailmenot.com	nil
hatena.ne.jp	nil
mystartsearch.com	nil
gamefaqs.com	nil
youtube-mp3.org	nil
delta-homes.com	nil
hdzog.com	nil
ancestry.com	none	returnpath
sabah.com.tr	nil
siteadvisor.com	nil
slimspots.com	nil
putlocker.is	nil
glassdoor.com	nil
blogspot.jp	none	self:google
intoday.in	nil
aweber.com	none	self
playstation.com	nil
rottentomatoes.com	nil
sears.com	nil
mirror.co.uk	nil
woot.com	nil
abcnews.go.com	nil
mixi.jp	nil
ad132m.com	nil
taringa.net	invalid
sabq.org	nil
lazada.co.id	nil
kinogo.co	nil
enet.com.cn	nil
okcupid.com	nil
abril.com.br	nil
click4stat.com	nil
sakura.ne.jp	nil
donga.com	nil
torrentz.in	nil
tmz.com	nil
npr.org	nil
java.com	nil
mi.com	nil
codecanyon.net	nil
pof.com	nil
blog.me	nil
ganji.com	nil
nbcnews.com	nil
constantcontact.com	none	self,dmarcian
jimdo.com	nil
tabelog.com	nil
costco.com	none	self
cityadspix.com	nil
nifty.com	none	self
instructables.com	nil
4dsply.com	nil
11st.co.kr	nil
hespress.com	nil
people.com	nil
discovercard.com	quarantine	returnpath
streamcloud.eu	nil
moneycontrol.com	nil
pinimg.com	nil
lifebuzz.com	nil
lenovo.com	nil
urbandictionary.com	nil
olx.pl	nil
subito.it	nil
allrecipes.com	none	
cnzz.com	nil
box.com	reject	agari
interia.pl	nil
google.co.hu	reject	self:google
southwest.com	none	returnpath
58.com	nil
aparat.com	nil
statcounter.com	nil
houzz.com	none	self
17ok.com	nil
stockstar.com	nil
bukalapak.com	nil
verizon.com	quarantine	returnpath
chip.de	nil
onlylady.com	nil
iplt20.com	nil
domaintools.com	nil
youjizz.com	nil
priceline.com	none	self
zing.vn	nil
airtel.in		
overstock.com	none	returnpath
php.net	nil
ewt.cc	nil
shopify.com	none	self
workercn.cn	nil
so-net.ne.jp	none	
fidelity.com	quarantine	returnpath
goodgamestudios.com	nil
ebay.fr	none	agari,returnpath
wonderlandads.com	nil
lenta.ru	nil
rednet.cn	nil
list.tmall.com	nil
urdupoint.com	nil
windows.com	nil
epweike.com	nil
timeanddate.com	nil
shareba.com	nil
ero-video.net	nil
myway.com	nil
jrj.com.cn	nil
what-character-are-you.com	nil
youdao.com	nil
fanli.com	nil
voc.com.cn	nil
tnaflix.com	nil
swagbucks.com	invalid
zulily.com	none	self
drudgereport.com	nil
blogspot.mx	none	self:google
bhphotovideo.com	nil
pcpop.com	nil
wetransfer.com	nil
xunlei.com	nil
japanpost.jp	nil
pantip.com	nil
dianping.com	nil
bodybuilding.com	nil
bitly.com	none	self
latimes.com	nil
makemytrip.com	nil
pch.com	reject	returnpath
vnexpress.net	nil
vcommission.com	nil
neobux.com	reject	dmarcian
cnblogs.com	nil
wired.com	nil
hostgator.com	nil
commentcamarche.net	nil
porn.com	invalid
google.co.nz	reject	self:google
mercadolibre.com.ve	nil
slack.com	none	dmarcian
squarespace.com	none	agari,self,dmarcian
livescore.com	nil
gawker.com	invalid
twoo.com	nil
hudong.com	nil
williamhill.com	nil
billdesk.com	nil
gismeteo.ru	nil
albawabhnews.com	nil
cbssports.com	nil
digikala.com	nil
kdnet.net	nil
omnaling.com	nil
nownews.com	nil
cracked.com	invalid
change.org	none	returnpath
slate.com	nil
chron.com	nil
ca.gov	nil
sex.com	nil
biglobe.ne.jp	none	
staples.com	nil
blogspot.co.uk	none	self:google
appledaily.com.tw	nil
ehow.com	nil
focus.de	nil
ci123.com	nil
haber7.com	nil
ew.com	nil
rapidgator.net	nil
asana.com	none	postmarkapp
douyutv.com	nil
nmisr.com	nil
yts.to	none	self
el-balad.com	nil
globososo.com	nil
pcmag.com	nil
shareasale.com	nil
statsmobi.com	nil
cookpad.com	nil
ad120m.com	nil
iflscience.com	nil
315che.com	nil
moz.com	nil
ucoz.ru	nil
lefigaro.fr	nil
nydailynews.com	nil
exblog.jp	nil
mercadolibre.com.mx	nil
myfitnesspal.com	none	messagebus
ria.ru	nil
united.com	nil
drtuber.com	nil
goo.gl	none	self:google
e-hentai.org	nil
r10.net	nil
eventbrite.com	nil
news.com.au	nil
leagueoflegends.com	nil
udemy.com	nil
bookmyshow.com	nil
filmon-ads.com	nil
lemonde.fr	nil
academia.edu	nil
chinaso.com	nil
rightmove.co.uk	nil
zoho.com	nil
babycenter.com	nil
google.bg	none	self:google
tokopedia.com	nil
lolwot.com	nil
etao.com	nil
torcache.net	nil
ptt01.cc	nil
custhelp.com	none	self
gyazo.com	nil
state.gov	nil
nfl.com	nil
aa.com	nil
nikkei.com	nil
weblio.jp	nil
atwiki.jp	nil
elwatannews.com	nil
zappos.com	invalid
elmogaz.com	nil
primewire.ag	nil
momoshop.com.tw	nil
soku.com	nil
prntscr.com	nil
cnbc.com	nil
doubleclick.com	none	self:google
k618.cn	nil
wiktionary.org	nil
clien.net	nil
as.com	nil
wav.tv	invalid
f54d6bf2b1.se	nil
medium.com	none	messagebus
coursera.org	nil
milanuncios.com	nil
patch.com	nil
mynet.com	nil
vi-view.com	nil
researchgate.net	invalid
asus.com	nil
backpage.com	nil
superuser.com	nil
emol.com	nil
ibm.com	nil
thehindu.com	nil
westernjournalism.com	nil
vine.co	none	
lapatilla.com	nil
indianrail.gov.in	nil
google.com.kw	none	self:google
adsrvmedia.net	nil
auction.co.kr	nil
cricbuzz.com	nil
google.lk	none	self:google
friv.com	nil
bidvertiser.com	nil
reverso.net	nil
terraclicks.com	nil
smartshopping.com	nil
junbi-tracker.com	nil
yandex.com.tr	nil
blackboard.com	nil
mynavi.jp	nil
sbnation.com	nil
affclicker.com	nil
abplive.in	nil
coupons.com	nil
semrush.com	nil
wetter.com	nil
myntra.com	nil
geocities.jp	nil
www.gov.uk	nil
acfun.tv	nil
foodnetwork.com	nil
cdiscount.com	quarantine	
ebates.com	nil
google.rs	none	self:google
mihanblog.com	nil
ytimg.com	none	self:google
usaa.com	none	agari,returnpath
trklnks.com	nil
warofclicks.com	nil
ig.com.br	reject	self
nike.com	nil
mackeeper.com	reject	
facenama.com	nil
sh.st	nil
sciencedirect.com	none	agari,unknown:dmarc-a@lexisnexis.com
tomshardware.com	nil
ruten.com.tw	nil
all2lnk.com	nil
indianexpress.com	nil
yodobashi.com	nil
match.com	none	returnpath
yandex.kz	nil
mayoclinic.org	nil
sulekha.com	invalid
usbank.com	none	agari
elfagr.org	nil
ted.com	nil
forever21.com	nil
sfgate.com	nil
delta.com	none	returnpath
104.com.tw	nil
gemius.pl	nil
usmagazine.com	nil
gazzetta.it	nil
freepik.com	nil
altervista.org	nil
asahi.com	nil
emgn.com	nil
nate.com	nil
europa.eu	nil
saramin.co.kr	nil
mackolik.com	nil
omiga-plus.com	nil
istartsurf.com	nil
tagged.com	nil
nhk.or.jp	invalid
126.com	none	
xing.com	none	returnpath
kotaku.com	invalid
trafficoptimisr.com	nil
lequipe.fr	nil
behance.net	nil
blogspot.com.tr	none	self:google
webex.com	nil
anitube.se	nil
jcpenney.com	nil
india.com	nil
histats.com	nil
bluehost.com	nil
pchome.com.tw	nil
renren.com	nil
weather.gov	nil
monster.com	nil
mbc.net	nil
adp.com	reject	agari
yandex.by	nil
elance.com	invalid
gamespot.com	nil
cbs.com	nil
filehippo.com	nil
sfr.fr	nil
sky.com	nil
liveleak.com	nil
novinky.cz	nil
free-tv-video-online.info	nil
indiaresults.com	nil
mit.edu	nil
cbsnews.com	nil
blogspot.de	none	self:google
xbox.com	nil
webcrawler.com	nil
vk.me	nil
myfreecams.com	nil
irs.gov	none	self
sapo.pt	nil
deviantart.net	nil
terra.com.br	nil
letv.com	nil
cisco.com	none	self
olx.com.br	nil
basecamp.com	none	self
dreamstime.com	nil
gumtree.com	none	agari
ticketmaster.com	nil
tahrirnews.com	nil
disney.go.com	nil
adme.ru	nil
android.com	none	self:google
how-old.net	nil
olx.ua	invalid
vetogate.com	nil
4chan.org	reject	
entrepreneur.com	nil
gofundme.com	nil
tinyurl.com	nil
cpasbien.pw	nil
t-mobile.com	nil
gutefrage.net	nil
google.hr	none	self:google
netteller.com	nil
trovi.com	nil
nhl.com	nil
wayfair.com	nil
itmedia.co.jp	nil
biobiochile.cl	nil
investopedia.com	nil
himado.in	nil
in.com	nil
hatenablog.com	nil
whitepages.com	nil
bahn.de	none	unknown:dmarc.reporting@deutschebahn.com
nypost.com	nil
popsugar.com	nil
farsnews.com	nil
cbc.ca	nil
am15.net	nil
cbslocal.com	nil
adrotator.se	nil
21cn.com	nil
almasryalyoum.com	nil
clarin.com	none	
digg.com	nil
lun.com	nil
huaban.com	nil
google.by	reject	self:google
io9.com	invalid
hardsextube.com	nil
padsdel.com	nil
yellowpages.com	nil
allocine.fr	nil
2chblog.jp	nil
livestrong.com	nil
22find.com	nil
123rf.com	nil
tsite.jp	nil
howtogeek.com	nil
hubspot.com	none	dmarcian,self
marktplaats.nl	none	self,dmarcian
gigazine.net	nil
dafont.com	nil
pagesjaunes.fr	nil
marketwatch.com	nil
iminent.com	nil
ebay.ca	none	agari,returnpath
immobilienscout24.de	none	agari,self
watch-series-tv.to	nil
mobtimizer.com	nil
safehomepage.com	nil
deezer.com	nil
ampclicks.com	nil
lanacion.com.ar	nil
offpageads.com	nil
blomaga.jp	nil
yomiuri.co.jp	nil
gamepedia.com	nil
food.com	nil
clicksvenue.com	nil
focus.cn	nil
fitbit.com	nil
mobtada.com	nil
carview.co.jp	nil
sahadan.com	nil
idnes.cz	nil
informer.com	nil
wattpad.com	none	self
google.com.ec	reject	self:google
tripadvisor.co.uk	nil
audible.com	nil
walgreens.com	nil
mapquest.com	nil
fandango.com	nil
masrawy.com	nil
techradar.com	nil
qingdaonews.com	nil
truemediapipe.com	nil
189.cn	nil
google.kz	reject	self:google
marriott.com	nil
rakuten.ne.jp	nil
track300.com	nil
todayhumor.co.kr	nil
blogspot.ru	none	self:google
nikkeibp.co.jp	invalid
ultimate-guitar.com	none	self
sharepoint.com	nil
114la.com	nil
p1mods.com	nil
ldblog.jp	nil
firstpost.com	none	dmarcian
efix.com	nil
thedailybeast.com	nil
zara.com	nil
viralnova.com	nil
zone-telechargement.com	nil
nbcsports.com	nil
merriam-webster.com	nil
atlassian.net	nil
barnesandnoble.com	nil
prezi.com	none	dmarcanalyzer
adultfriendfinder.com	nil
topix.com	nil
movie4k.to	nil
dubizzle.com	nil
littlethings.com	nil
folha.uol.com.br	nil
uber.com	none	self,agari
clipconverter.cc	nil
jobrapido.com	nil
yhd.com	nil
intel.com	nil
smh.com.au	nil
deadspin.com	invalid
narod.ru	nil
mediaset.it	nil
scoop.it	nil
face-masr.com	nil
xtube.com	nil
roblox.com	nil
jin115.com	nil
theblaze.com	nil
indiamart.com	nil
norton.com	nil
media-fire.org	nil
motherless.com	nil
jumia.com.ng	nil
ixxx.com	nil
prothom-alo.com	nil
microsoftstore.com	nil
cocolog-nifty.com	nil
sozcu.com.tr	nil
googleapis.com	none	self:google
drom.ru	nil
oyunskor.com	nil
thekitchn.com	invalid
investing.com	nil
shaadi.com	nil
upwork.com	nil
stanford.edu	nil
gittigidiyor.com	none	returnpath
y8.com	invalid
eenadu.net	nil
24h.com.vn	quarantine	self
mail.com	nil
apache.org	nil
nationalgeographic.com	nil
nuvid.com	nil
ccb.com	nil
6park.com	nil
2ch-c.net	nil
linkwithin.com	nil
bedbathandbeyond.com	nil
tutorialspoint.com	nil
wiley.com	nil
images-amazon.com	nil
faithtap.com	nil
comcast.com	nil
dict.cc	nil
hindustantimes.com	nil
bt.com	nil
donanimhaber.com	nil
foursquare.com	none	self
hgtv.com	none	agari
tabnak.ir	nil
typepad.com	nil
9cc85d.se	nil
ad4game.com	nil
yam.com	nil
clickadu.com	nil
tesco.com	nil
virgilio.it	none	self,returnpath
gazeta.ru	nil
istockphoto.com	nil
lotour.com	nil
dangdang.com	nil
banggood.com	nil
alfalfalfa.com	nil
wp.com	none	dmarcian
persianblog.ir	nil
po.st	nil
tribunnews.com	invalid
ashleymadison.com	reject	self
instructure.com	nil
shutterfly.com	none	self
ensonhaber.com	nil
battlefield.com	nil
distractify.com	nil
cnmo.com	nil
vesti.ru	nil
chosun.com	nil
hubpages.com	nil
correios.com.br	nil
haberturk.com	nil
buy.tmall.com	nil
w3.org	nil
inquirer.net	nil
digitaltrends.com	nil
si.com	nil
mediaplex.com	nil
ryanair.com	nil
sporx.com	nil
pixabay.com	nil
profitboosterapp.com	nil
macrumors.com	nil
infobae.com	nil
idealo.de	nil
androidcentral.com	nil
sanook.com	nil
legacy.com	invalid
nu.nl	nil
disq.us	nil
4399.com	nil
spankwire.com	nil
videomega.tv	nil
cnbeta.com	nil
zhaopin.com	nil
biblegateway.com	nil
postimg.org	nil
makeuseof.com	nil
brainyquote.com	nil
telegraaf.nl	nil
ukr.net	nil
seasonvar.ru	nil
imobile.com.cn	nil
abc.es	nil
totaladperformance.com	nil
alarabiya.net	nil
niuche.com	nil
7769domain.com	nil
finn.no	none	self,agari
leadpages.net	nil
chekb.com	nil
samsclub.com	nil
salon.com	nil
creditkarma.com	nil
redfin.com	nil
hilton.com	nil
onlinecreditcenter6.com	none	agari
google.com.do	none	self:google
nasa.gov	nil
suning.com	nil
drugs.com	none	self
harvard.edu	nil
oneindia.com	nil
video-one.com	nil
discogs.com	nil
excite.co.jp	nil
crsdrz.com	nil
xsrving.com	nil
messenger.com	reject	agari,unknown:postmaster@facebook.com
infoseek.co.jp	nil
garmin.com	nil
2345.com	nil
vsuch.com	nil
conduit.com	nil
ebay.es	none	agari,returnpath
gazetaexpress.com	nil
n11.com	nil
americanas.com.br	nil
quanjing.com	nil
abc.net.au	nil
gigacircle.com	nil
qslpdk.com	nil
rei.com	nil
360doc.com	nil
itau.com.br	none	returnpath
getpocket.com	nil
freelotto.com	nil
imagebam.com	nil
fanfiction.net	nil
google.lt	reject	self:google
td.com	nil
babylon.com	nil
sankei.com	nil
jia.com	nil
ad6media.fr	nil
credit-agricole.fr	nil
interpark.com	nil
discuss.com.hk	invalid
boredpanda.com	nil
codeproject.com	nil
kbb.com	nil
takungpao.com	nil
otto.de	nil
shaparak.ir	nil
fotostrana.ru	quarantine	self
plarium.com	none	self
jagran.com	nil
pnc.com	nil
complex.com	nil
yenisafak.com.tr	nil
brassring.com	nil
vg.no	nil
liveperson.net	nil
suara.com	nil
nocookie.net	invalid
turbobit.net	nil
chexun.com	nil
yadi.sk	nil
jw.org	nil
royalbank.com	nil
mint.com	none	agari
qvc.com	nil
askubuntu.com	nil
gamersky.com	nil
mtv.com	nil
warriorforum.com	nil
skysports.com	nil
couchtuner.eu	nil
tutsplus.com	nil
kioskea.net	nil
lightinthebox.com	nil
to8to.com	nil
525j.com.cn	nil
usnews.com	nil
ocn.ne.jp	nil
garanti.com.tr	nil
jezebel.com	invalid
yaplakal.com	nil
citrixonline.com	nil
gumtree.com.au	none	agari
zergnet.com	nil
echo.msk.ru	nil
retkow.com	nil
rarbg.to	nil
mbank.pl	nil
websta.me	nil
citibank.co.in	none	agari,self
southcn.com	nil
aastocks.com	nil
o2.pl	nil
autotrader.com	nil
theatlantic.com	nil
thechive.com	invalid
iciba.com	nil
arstechnica.com	nil
beytoote.com	nil
rakuten.com	nil
chefkoch.de	nil
mgid.com	nil
heise.de	nil
uploadable.ch	nil
kicker.de	nil
ilmeteo.it	nil
dhl.de	reject	agari
dropbooks.tv	nil
tripadvisor.in	nil
hepsiburada.com	nil
korabia.com	nil
esuteru.com	nil
wwwpromoter.com	nil
klikbca.com	nil
worldstarhiphop.com	invalid
netshoes.com.br	nil
welt.de	nil
oschina.net	nil
airasia.com	nil
anjuke.com	nil
3dmgame.com	nil
meituan.com	quarantine	self
12306.cn	nil
9gag.tv	nil
windowsphone.com	nil
axisbank.com	nil
leo.org	nil
miniclip.com	nil
mangafox.me	nil
megaoferta.net	nil
chiphell.com	nil
pole-emploi.fr	nil
juksy.com	nil
hollywoodreporter.com	nil
qidian.com	nil
today.com	nil
wiocha.pl	nil
caixa.gov.br	nil
jeuxvideo.com	nil
labanquepostale.fr	nil
alohatube.com	nil
thisav.com	nil
getbootstrap.com	nil
iconosquare.com	nil
amoory.com		
inc.com	nil
uniqlo.com	nil
argos.co.uk	nil
bankmellat.ir	nil
clixsense.com	nil
springer.com	nil
indiegogo.com	nil
dpreview.com	nil
linternaute.com	nil
4pda.ru	nil
polyvore.com	nil
genius.com	nil
ed.gov	none	self
zedo.com	none	agari
super.cz	nil
akhbarelyom.com	nil
vente-privee.com	nil
lloydsbank.co.uk	reject	agari
qualtrics.com	nil
zhibo8.cc	none	self:netease
hyperpromote.com	nil
cafemom.com	nil
hexun.com	nil
rojadirecta.me	nil
lacaixa.es	nil
strava.com	nil
pbs.org	nil
jalan.net	nil
list-manage1.com	invalid
olx.co.id	nil
duba.com	nil
rockstargames.com	nil
discover.com	none	returnpath
panet.co.il	nil
ly.com	nil
humblebundle.com	nil
mangareader.net	reject	self
autoscout24.de	nil
lg.com	nil
auto.ru	nil
quizlet.com	none	postmarkapp
dhgate.com	nil
mydrivers.com	nil
lego.com	none	returnpath,dmarcian
contentjs.com	nil
kuronekoyamato.co.jp	nil
orbitz.com	nil
linkbucks.com	nil
searchengineland.com	nil
impots.gouv.fr	nil
bitbucket.org	invalid
cvs.com	nil
onliner.by	invalid
wargaming.net	none	self
ouedkniss.com	nil
tgbus.com	nil
ccebba93.se	nil
rollingstone.com	nil
blogspot.tw	none	self:google
ctrip.com	nil
seekingalpha.com	nil
blackhatworld.com	nil
51job.com	nil
abc.go.com	nil
tinnhanh360.net	nil
tvguide.com	nil
kizi.com	nil
programme-tv.net	nil
doisongphapluat.com	nil
phonearena.com	nil
serverfault.com	nil
doodle.com	invalid
over-blog.com	nil
victoriassecret.com	nil
hellou.co.uk	nil
ft.com	nil
piriform.com	nil
xiami.com	nil
nairaland.com	nil
craigslist.ca	none	dmarcian
docin.com	nil
cars.com	none	dmarcian,self
ecnavi.jp	nil
ptt.cc	nil
meteofrance.com	nil
mangahere.co	nil
sueddeutsche.de	nil
weheartit.com	nil
sprint.com	nil
dostor.org	nil
hsbc.co.uk	none	agari
10jqka.com.cn	nil
misr5.com	nil
dlsite.com	nil
google.si	reject	self:google
ngacn.cc	nil
pixlr.com	nil
kimiss.com	nil
dailykos.com	nil
feng.com	nil
drive2.ru	nil
aftonbladet.se	nil
serving-sys.com	nil
voyeurhit.com	nil
popmyads.com	nil
katproxy.com	nil
ascii.jp	nil
pcworld.com	nil
zomato.com	nil
keezmovies.com	nil
reduxmediia.com	nil
sitepoint.com	invalid
crunchyroll.com	nil
fishki.net	none	self
onlinerewardcenter.net	nil
hh.ru	none	self
pressroomvip.com	nil
nudevista.com	nil
mydala.com	quarantine	self
refinery29.com	nil
light1box.com	nil
fool.com	nil
slrclub.com	nil
tvn24.pl	nil
gozooms.com	nil
who.is	invalid
1and1.com	nil
vox.com	nil
20minutes.fr	nil
haberler.com	nil
flirt4free.com	quarantine	self
adslgate.com	nil
merdeka.com	nil
syosetu.com	nil
qianlong.com	nil
nikkansports.com	nil
sephora.com	nil
rtl.de	nil
livingsocial.com	reject	agari,self,returnpath
amarujala.com	nil
yahoo-mbga.jp	nil
depositphotos.com	invalid
askmebazaar.com	nil
schwab.com	none	self,agari,returnpath
zeroredirect1.com	nil
giphy.com	nil
tomsguide.com	nil
dcinside.com	nil
tunein.com	nil
picmonkey.com	nil
all-free-download.com	nil
getresponse.com	none	self
orf.at	nil
cinemablend.com	nil
commbank.com.au	none	self
popupads.ir	nil
zougla.gr	nil
ning.com	nil
vodlocker.com	nil
blogspot.kr	none	self:google
gotowebinar.com	nil
starsports.com	nil
city-data.com	invalid
elcomercio.pe	nil
gnavi.co.jp	nil
gamestop.com	none	self
sunporno.com	nil
championat.com	nil
adxcore.com	invalid
criteo.com	nil
berkeley.edu	nil
bloglovin.com	nil
tut.by	nil
evite.com	nil
scoopwhoop.com	nil
habrahabr.ru	invalid
nosub.tv	nil
dmv.org	nil
radikal.com.tr	nil
uproxx.com	nil
iherb.com	nil
nextmedia.com	nil
mtsindia.in	nil
sponichi.co.jp	nil
postbank.de	nil
bandcamp.com	nil
ibtimes.com	nil
xueqiu.com	nil
aljazeera.net	nil
ubuntu.com	nil
vistaprint.com	none	returnpath,self
line.me	nil
yoka.com	nil
noaa.gov	nil
bab.la	nil
mufg.jp	none	agari
porntube.com	nil
avira.com	nil
thenextweb.com	nil
internethaber.com	nil
t411.io	nil
lockerdome.com	nil
pikabu.ru	nil
gaana.com	nil
bankrate.com	nil
p5w.net	nil
clickbank.com	nil
cleartrip.com	nil
gstatic.com	none	self:google
elconfidencial.com	nil
caixin.com	nil
breitbart.com	nil
cheezburger.com	nil
elitedaily.com	nil
kongregate.com	nil
buscape.com.br	nil
panasonic.jp	nil
toysrus.com	nil
edmunds.com	nil
rozblog.com	nil
freelancer.com	none	agari,self
google.iq	none	self:google
zozo.jp	nil
opensubtitles.org	nil
sanjesh.org	nil
m-w.com	nil
unam.mx	nil
mxttrf.com	nil
fang.com	nil
picofile.com	nil
esporte.uol.com.br	nil
earthlink.net	nil
cam4.com	nil
ea.com	nil
mpnrs.com	nil
mcafee.com	nil
azet.sk	quarantine	self
internetdownloadmanager.com	nil
howstuffworks.com	nil
staticflickr.com	reject	self:yahoo
jquery.com	nil
yr.no	nil
webmoney.ru	nil
mic.com	invalid
danawa.com	nil
metrolyrics.com	nil
megafilmeshd.net	nil
metro.co.uk	nil
bookryanair.com	nil
kinox.to	nil
1und1.de	nil
cambridge.org	nil
barclaycardus.com	nil
yahoo.net	reject	self:yahoo
pornmd.com	nil
vrbo.com	reject	agari,haspf
starbucks.com	nil
lynda.com	none	agari
jalopnik.com	invalid
promoads.net	nil
tigerdirect.com	nil
kmart.com	nil
ceneo.pl	nil
metacritic.com	nil
walmart.com.br	none	returnpath
unity3d.com	nil
zimbio.com	nil
google.com.gt	none	self:google
kompasiana.com	nil
capitalone360.com	none	agari
sakshi.com	nil
aliyun.com	quarantine	self
gog.com	nil
gumtree.co.za	nil
fanpage.gr	nil
xdf.cn	nil
1webcatalog.com	nil
sony.jp	nil
tinypic.com	nil
argaam.com	nil
admaimai.com	nil
ozon.ru	nil
smi2.ru	invalid
lazada.vn	nil
careerbuilder.com	nil
voyages-sncf.com	nil
web.tv	nil
divar.ir	nil
joins.com	nil
uptobox.com	nil
pogo.com	nil
imagefap.com	nil
dw.de	nil
vip.com	nil
premierleague.com	nil
icims.com	none	dmarcian
envato.com	none	self
virginmedia.com	nil
haraj.com.sa	nil
bizjournals.com	nil
vporn.com	nil
telegrafi.com	nil
nouvelobs.com	nil
baiducontent.com	nil
duolingo.com	nil
economist.com	nil
jcrew.com	nil
chicagotribune.com	nil
zazzle.com	nil
nitroflare.com	nil
solarmovie.is	nil
5278.cc	nil
autotrader.co.uk	none	agari,self,returnpath
privilegesbox.net	nil
dagbladet.no	nil
jugem.jp	nil
dx.com	nil
examiner.com	nil
mtime.com	nil
otomoto.pl	invalid
rutor.org	nil
billboard.com	nil
primosearch.com	nil
shine.com	nil
zdnet.com	nil
startimes.com	nil
easyjet.com	nil
psu.edu	nil
500px.com	nil
dhl.com	reject	agari
jsfiddle.net	nil
webs.com	nil
fortune.com	nil
opentable.com	nil
codepen.io	nil
xkcd.com	nil
r7.com	nil
porntubemovs.net	nil
smallseotools.com	nil
v9.com	nil
flightradar24.com	invalid
olx.ro	nil
douguo.com	nil
medicinenet.com	nil
gilt.com	nil
canva.com	none	self
ynet.co.il	nil
justporno.tv	nil
dnaindia.com	nil
myanimelist.net	nil
ilfattoquotidiano.it	nil
upworthy.com	nil
masralarabia.com	nil
kapook.com	nil
last.fm	nil
xmediaserve.com	nil
1337x.to	nil
mplife.com	nil
sweet-page.com	nil
ing.nl	reject	unknown:Global.Mail.DMARC@ing.net,dmarcian,self
filmibeat.com	nil
zeit.de	nil
upsocl.com	nil
inspsearch.com	nil
kissanime.com	nil
yapo.cl	nil
patheos.com	nil
moviepilot.com	nil
rappler.com	nil
consumerreports.org	nil
jma.go.jp	nil
greatergood.com	nil
freegameszonetab.com	nil
axisbank.co.in	nil
akicihaber.com.tr	nil
templatemonster.com	nil
ibtimes.co.uk	nil
joomla.org	nil
cosmopolitan.com	nil
ehowenespanol.com	nil
gotomeeting.com	nil
brazzers.com	nil
tobogo.net	nil
foxsports.com	nil
ustream.tv	nil
news24.com	nil
mysql.com	nil
etorrent.co.kr	nil
google.lv	reject	self:google
jpnn.com	nil
grantland.com	invalid
ccidnet.com	nil
nexusmods.com	nil
tiscali.it	nil
codecademy.com	nil
dojki.com	nil
santander.co.uk	none	agari
gtmetrix.com	nil
qunar.com	nil
qz.com	nil
aarp.org	invalid
dropboxusercontent.com	none	agari
shop-pro.jp	nil
homeaway.com	reject	agari,haspf
sape.ru	nil
wildberries.ru	nil
nowvideo.sx	nil
shahrekhabar.com	nil
wwe.com	nil
paytm.in	nil
cloudflare.com	quarantine	self,dmarcian
egrana.com.br	nil
editor.wix.com	nil
wowhead.com	nil
softpedia.com	nil
telekom.com	nil
himasoku.com	nil
livetv.sx	nil
sport1.de	nil
popmaster.ir	nil
manoramaonline.com	nil
ringring.vn	nil
national-lottery.co.uk	nil
linio.com.mx	nil
batanga.com	nil
asriran.com	nil
mashreghnews.ir	nil
forgeofempires.com	nil
pcgamer.com	nil
eztv.ch	nil
urbanoutfitters.com	nil
citi.com	none	agari,self
theweathernetwork.com	nil
kienthuc.net.vn	nil
banesconline.com	nil
nymag.com	nil
poste.it	nil
dantri.com.vn	nil
sport.es	nil
way2sms.com	nil
okwave.jp	nil
nnm-club.me	nil
rakuten-card.co.jp	nil
realsimple.com	nil
ihg.com	nil
dribbble.com	none	postmarkapp
nbc.com	invalid
paidverts.com	nil
junglee.com	nil
meishichina.com	nil
6e2bd3848d2b73.se	nil
graphicriver.net	nil
segundamano.es	nil
cloob.com	nil
couchtuner.eu.com	nil
delta-search.com	nil
baixaki.com.br	invalid
rightel.ir	nil
kp.ru	nil
liveadoptimizer.com	nil
gsshop.com	nil
slashdot.org	nil
realestate.com.au	none	self
televisionfanatic.com	nil
officedepot.com	nil
netdna-cdn.com	nil
newyorker.com	nil
duowan.com	nil
nature.com	nil
index.hu	nil
torrentdn.com	nil
17173.com	nil
ampxchange.com	nil
hamusoku.com	nil
eluniversal.com.mx	nil
unicredit.it	nil
state.tx.us	nil
kapanlagi.com	nil
reclameaqui.com.br	nil
msdn.com	nil
inquisitr.com	nil
wetteronline.de	nil
2gis.ru	nil
20minutos.es	nil
ssisurveys.com	nil
indeed.co.in	nil
mileroticos.com	nil
peyvandha.ir	nil
trovigo.com	nil
fazenda.gov.br	nil
nipic.com	nil
fatwallet.com	nil
greatandhra.com	nil
filmweb.pl	nil
gumtree.pl	none	self
fastpic.ru	nil
viva.co.id	nil
zwaar.org	nil
pastebin.com	nil
monografias.com	nil
yixun.com	nil
fanhuan.com	nil
disney.com	nil
baimao.com	nil
rtve.es	nil
khanacademy.org	nil
trafficfactory.biz	nil
mundodeportivo.com	nil
samplicio.us	nil
keepvid.com	nil
ahrefs.com	nil
mts.ru	nil
traidnt.net	nil
bradesco.com.br	nil
ad123m.com	nil
dawn.com	nil
timewarnercable.com	nil
iza.ne.jp	nil
submarino.com.br	none	returnpath
say-move.org	nil
xiaomi.com	nil
planetromeo.com	nil
mysmartprice.com	nil
alicdn.com	nil
okezone.com	nil
hibapress.com	nil
aizhan.com	nil
accountonline.com	none	agari,self
yallakora.com	nil
tripadvisor.it	nil
videodownloadconverter.com	nil
priceminister.com	none	self
1tv.ru	nil
lumosity.com	none	unknown:email-abuse@lumoslabs.com
wunderlist.com	nil
blockthis.es	nil
blogsky.com	nil
rackspace.com	nil
bs.to	nil
4tube.com	nil
trademe.co.nz	reject	returnpath
zopim.com	nil
willhaben.at	nil
aljaras.com	nil
2chan.net	nil
dl-protect.com	nil
e97527f0.se	nil
hotpepper.jp	nil
idealista.com	nil
digitalocean.com	none	dmarcian
51cto.com	nil
maybank2u.com.my	nil
britishairways.com	none	returnpath
csgolounge.com	nil
52pk.com	nil
zalando.de	nil
playbuzz.com	nil
health.com	nil
sp.gov.br	nil
bmi.ir	nil
indeed.co.uk	nil
17track.net	nil
avito.ma	nil
musica.com	nil
cmbchina.com	nil
bayt.com	nil
businessweekly.com.tw	nil
115.com	nil
lifenews.ru	nil
cc.com	nil
directv.com	nil
lifehack.org	nil
buffer.com	nil
elegantthemes.com	nil
vmware.com	nil
teamviewer.com	quarantine	returnpath,self
nrk.no	nil
pornsharing.com	nil
google.co.ma	reject	self:google
jb51.net	nil
ksl.com	nil
uludagsozluk.com	invalid
myspace.com	invalid
reallifecam.com	nil
khabaronline.ir	nil
redbox.com	nil
hotukdeals.com	nil
mangapanda.com	reject	self
zum.com	nil
gamme.com.tw	nil
emirates.com	nil
ranker.com	nil
telecomitalia.it	nil
skyscanner.net	nil
vgsgaming-ads.com	nil
magicbricks.com	none	self
blog.ir	nil
hotwire.com	nil
cornell.edu	nil
stern.de	nil
newsnow.co.uk	nil
zwaar.net	nil
99acres.com	nil
ny.gov	nil
avclub.com	nil
buzzhand.com	nil
wemakeprice.com	nil
imgchili.net	nil
lonelyplanet.com	nil
rdsa2012.com	nil
bol.com	none	dmarcian
soccerway.com	nil
videoyoum7.com	nil
vodafone.in	nil
tripadvisor.fr	nil
cityheaven.net	nil
sports.ru	nil
wykop.pl	quarantine	
fakt.pl	nil
konga.com	nil
caisse-epargne.fr	nil
bamilo.com	nil
hihi2.com	nil
mentalfloss.com	nil
hulu.jp	nil
yiqifa.com	nil
mbank.com.pl	nil
cnki.net	nil
angieslist.com	nil
redirectvoluum.com	nil
bdnews24.com	nil
toptenreviews.com	nil
kinozal.tv	nil
doc88.com	nil
jiameng.com	nil
fatakat.com	nil
likemag.com	nil
tune.pk	nil
xvideo-jp.com	nil
nttdocomo.co.jp	nil
tv.com	nil
dummies.com	nil
motthegioi.vn	nil
computerbild.de	nil
qklnk.co	nil
tebyan.net	nil
sport.cz	nil
wikispaces.com	invalid
fnac.com	nil
cox.net	nil
google.az	reject	self:google
variety.com	invalid
house365.com	nil
usagc.org	nil
ieee.org	nil
makepolo.com	nil
agar.io	nil
cdc.gov	nil
chess.com	none	
techtarget.com	nil
hstpnetwork.com	nil
ilsole24ore.com	nil
searchalgo.com	nil
urbanspoon.com	nil
privatbank.ua	nil
bustle.com	nil
gamewith.jp	nil
rakuten-bank.co.jp	nil
autoblog.com	nil
bbb.org	reject	agari
kinja.com	invalid
ashemaletube.com	nil
pps.tv	nil
purdue.edu	nil
ucoz.com	nil
similarweb.com	nil
stubhub.com	none	agari
flipboard.com	nil
ucla.edu	nil
barclays.co.uk	nil
manta.com	nil
miniinthebox.com	nil
togetter.com	nil
rr.com	nil
google.com.pr	reject	self:google
consumers-reviews.info	nil
layalina.com	nil
manager.co.th	nil
eroprofile.com	nil
avxhome.se	nil
adk2.co	nil
carwale.com	nil
infospace.com	nil
aucfan.com	nil
moneysavingexpert.com	none	returnpath
zoopla.co.uk	nil
fanatik.com.tr	nil
hsbc.com.hk	none	agari
wimp.com	nil
guokr.com	nil
washington.edu	nil
privalia.com	nil
plurk.com	nil
10086.cn	nil
sou300.com	nil
leparisien.fr	nil
bioyun.com	nil
yjc.ir	nil
ilbe.com	nil
pudelek.pl	nil
lavanguardia.com	nil
archiveofourown.org	nil
instela.com	nil
nextdoor.com	nil
shufoo.net	nil
autodesk.com	nil
sierratradingpost.com	quarantine	self
newsmth.net	nil
irpopup.ir	nil
tass.ru	nil
n-tv.de	nil
blocket.se	reject	returnpath,self
rg.ru	nil
fetlife.com	nil
miercn.com	nil
spankbang.com	nil
techtudo.com.br	nil
weather.com.cn	nil
viadeo.com	nil
a10.com	nil
imagetwist.com	nil
ecollege.com	nil
hdfilmifullizle.com.tr	nil
albumsuper.info	nil
armorgames.com	nil
nguoiduatin.vn	nil
1111.tmall.com	nil
28.com	nil
fiducia.de	nil
frys.com	nil
fnb.co.za	nil
cda.pl	nil
akhbarak.net	nil
n-mobile.net	nil
skroutz.gr	nil
klma.org	nil
bb.com.br	nil
laposte.net	none	self,returnpath
ole.com.ar	none	
cj.com	nil
imujer.com	nil
allabout.co.jp	nil
olx.ph	nil
ulmart.ru	quarantine	
lazada.com.ph	nil
travelocity.com	nil
duden.de	nil
sonymobile.com	nil
moudamepo.com	nil
adam4adam.com	nil
faz.net	nil
worldoftanks.ru	nil
starwoodhotels.com	nil
timesjobs.com	nil
nesn.com	nil
anysex.com	nil
default-search.net	nil
safetracking.net	nil
adscale.de	nil
aljazeera.com	nil
sparknotes.com	nil
books.com.tw	nil
eltiempo.com	nil
iltalehti.fi	nil
express.co.uk	nil
censor.net.ua	nil
blic.rs	nil
alwafd.org	nil
sznews.com	nil
cafe24.com	nil
343.xyz	nil
hi5.com	reject	self
ynet.com	nil
secureinternetbank.com	nil
jobstreet.com	nil
namecheap.com	none	messagebus
tf1.fr	nil
fanpage.it	nil
doctissimo.fr	nil
zoosk.com	nil
ssg.com	nil
babal.net	nil
protothema.gr	nil
seriesflv.net	nil
timeout.com	none	self
miui.com	nil
comicbook.com	nil
hypergames.net	nil
ansa.it	nil
hongkiat.com	nil
pingdom.com	none	self,dmarcian
solarinstructions.com	nil
espnfc.com	nil
searchengines.guru	nil
ex.ua	nil
freejobalert.com	nil
kenh14.vn	nil
neogaf.com	nil
serviporno.com	nil
puu.sh	nil
amung.us	nil
lexpress.fr	nil
politico.com	nil
halifax-online.co.uk	reject	agari
hsn.com	nil
gearbest.com	nil
globaltestmarket.com	nil
rbcroyalbank.com	nil
mercola.com	nil
daily.co.jp	nil
wnd.com	nil
healthline.com	nil
emuch.net	nil
kijiji.it	invalid
2ch.sc	nil
noticias.uol.com.br	nil
ntv.ru	nil
medscape.com	nil
collegehumor.com	nil
ceconline.com	nil
theglobeandmail.com	nil
bttiantang.com	nil
gorillavid.in	nil
dealsplus.com	invalid
alexa.com	nil
yatra.com	nil
bigcinema.tv	nil
celebritytune.com	nil
178.com	nil
poco.cn	nil
dealnews.com	quarantine	self
sportsdirect.com	nil
szn.cz	nil
ly.net	nil
brides.com.cn	nil
zap2it.com	nil
myhabit.com	nil
empflix.com	nil
hamariweb.com	nil
caranddriver.com	nil
gazetevatan.com	nil
kddi.com	nil
chinabyte.com	nil
g2a.com	nil
agenziaentrate.gov.it	nil
utexas.edu	nil
centrum.cz	none	self
vanguard.com	reject	self
techbang.com	nil
list.ru	none	agari,unknown:dmarc_rua@corp.mail.ru,returnpath
dickssportinggoods.com	nil
iteye.com	nil
nametests.com	nil
columbia.edu	nil
suntrust.com	none	agari
asp.net	nil
familydoctor.com.cn	nil
fromdoctopdf.com	nil
windows.net	nil
boc.cn	nil
payu.in	none	self
forexfactory.com	nil
kaspersky.com	nil
etrade.com	nil
proboards.com	nil
bestblackhatforum.com	nil
google.com.bo	none	self:google
teespring.com	nil
bartarinha.ir	nil
lindaikeji.blogspot.com	nil
shopstyle.com	invalid
megogo.net	nil
apartmenttherapy.com	invalid
ravelry.com	none	self
bigcartel.com	nil
acesse.com	nil
mainichi.jp	nil
matomeantena.com	nil
facilisimo.com	nil
i.ua	none	unknown:dmarc-rua@mi6.kiev.ua
techrepublic.com	nil
bc.vc	nil
uscis.gov	nil
unblocked.pw	nil
1111.com.tw	nil
lidl.de	nil
arbeitsagentur.de	nil
ap.org	nil
mafengwo.cn	nil
sinerjihaber.com	nil
delfi.lt	nil
boxofficemojo.com	nil
popmog.com	nil
ralphlauren.com	nil
dinamalar.com	nil
rocketnews24.com	none	self
alyaoum24.com	nil
ticketmonster.co.kr	reject	self,agari
meb.gov.tr	nil
shop.com	nil
naij.com	nil
hellogiggles.com	nil
samanyoluhaber.com	nil
fotolia.com	nil
rackcdn.com	nil
infojobs.net	nil
adssend.net	nil
homeway.com.cn	nil
yourdictionary.com	nil
allmyvideos.net	nil
uefa.com	nil
ipage.com	nil
zerohedge.com	invalid
thrillist.com	none	self
umich.edu	none	self
chomikuj.pl	invalid
egou.com	nil
crunchbase.com	nil
deutsche-bank.de	none	self
blog.com	nil
lotterypost.com	nil
4gamer.net	nil
ycombinator.com	nil
sap.com	nil
twipple.jp	nil
liebelib.com	nil
bancomercantil.com	nil
tdbank.com	nil
cheatsheet.com	nil
zerkalo-rutor.org	nil
alimama.com	nil
jstor.org	nil
sedty.com	nil
aabe3b.se	nil
friendlife.com	invalid
westpac.com.au	none	returnpath
mbtrx.com	nil
multitran.ru	nil
mensxp.com	nil
rvfrm2006.com	nil
teslamotors.com	none	self
wannonce.com	nil
docusign.net	reject	agari,messagebus
money.pl	nil
elsevier.com	none	agari,self
yandex.com	nil
pornxs.com	nil
plala.or.jp	nil
hurriyetemlak.com	nil
hbogo.com	nil
www.nhs.uk	nil
qiwi.com	nil
rozetka.com.ua	invalid
xcams.com	nil
iautos.cn	nil
smugmug.com	nil
cnyes.com	nil
wpbeginner.com	nil
conservativetribune.com	nil
eroterest.net	nil
ana.co.jp	nil
perezhilton.com	nil
cabelas.com	nil
talk.tw	nil
atpworldtour.com	nil
avast.com	nil
mapy.cz	nil
screenrant.com	nil
ebocornac.com	nil
el-nacional.com	nil
thestreet.com	nil
made-in-china.com	nil
ficktricks.com	nil
att.net	nil
alice.it	nil
flipora.com	nil
jetblue.com	nil
ibanking-services.com	nil
inmotionhosting.com	nil
google.com.af	reject	self:google
huihui.cn	invalid
tukif.com	nil
tubelombia.com	nil
gocomics.com	nil
lazada.com.my	nil
junkmail.co.za	nil
everydayhealth.com	none	returnpath
pelis24.com	nil
livestream.com	nil
hotstar.com	nil
break.com	nil
wpmudev.org	invalid
commonfloor.com	invalid
whois.com	nil
xvideos-field5.com	nil
nguyentandung.org	nil
scotiabank.com	none	agari
r2games.com	nil
hugedomains.com	nil
myegy.to	nil
wetter.de	nil
adweek.com	nil
trends.com.cn	nil
hollywoodlife.com	nil
transfermarkt.de	nil
mthai.com	nil
boursorama.com	nil
logitech.com	nil
go2cloud.org	nil
8tracks.com	none	messagebus
drupal.org	nil
woothemes.com	nil
laplas.co	nil
trgino.com	nil
mvideo.ru	nil
surveyrouter.com	nil
365jia.cn	nil
yimg.com	reject	self:yahoo
weathernews.jp	nil
mdn2015x1.com	nil
pravda.com.ua	nil
theonion.com	nil
fanpop.com	nil
tokyo.jp	nil
coupondunia.in	nil
traveltune.com	nil
mudah.my	nil
boston.com	nil
dominos.com	nil
larousse.fr	nil
study.com	nil
aruba.it	none	self
skyrock.com	nil
thoughtcatalog.com	nil
python.org	none	postmarkapp
metrotvnews.com	nil
express.pk	nil
dns-shop.ru	nil
jagranjosh.com	nil
b9dm.com	nil
ubuntuforums.org	nil
fbsbx.com	nil
edx.org	nil
elmawke3.com	nil
unibet.com	nil
screencast.com	nil
sony.com	nil
24video.net	nil
indiaproperty.com	nil
bhg.com	nil
online-convert.com	none	self
dorkly.com	nil
mobilix.mobi	nil
square-enix.com	nil
baomihua.com	nil
adultadworld.com	nil
v3sm.com	nil
shopbop.com	nil
flashscore.com	nil
rikunabi.com	nil
askmen.com	nil
inven.co.kr	nil
diretta.it	nil
drugstore.com	nil
bgr.com	nil
housing.com	nil
betfair.com	nil
msnbc.com	nil
indiarailinfo.com	nil
geico.com	nil
ligtv.com.tr	nil
desi-tashan.com	nil
tenki.jp	nil
tasnimnews.com	nil
01net.com	nil
tmall.hk	nil
888casino.com	nil
anz.com	nil
58pic.com	nil
ali213.net	nil
dawanda.com	nil
eol.cn	nil
gfan.com	nil
letras.mus.br	nil
cdstm.cn	nil
google.jo	none	self:google
omgpm.com	nil
sparkpeople.com	nil
fastcompany.com	nil
lds.org	nil
shopathome.com	nil
onadstracker.com	nil
sport.pl	nil
4cdn.org	nil
societegenerale.fr	none	unknown: sg.postmaster@socgen.com
filmon.com	nil
yoox.com	nil
spanishdict.com	nil
bigpoint.com	nil
suumo.jp	invalid
creativemarket.com	invalid
pizzahut.com	nil
vagalume.com.br	nil
css-tricks.com	nil
freeones.com	nil
redbus.in	nil
telecinco.es	nil
famitsu.com	nil
dealmoon.com	nil
contemporaryhomedecor.org	nil
ifilez.org	nil
nyu.edu	nil
theage.com.au	nil
cardekho.com	nil
op.gg	nil
taoche.com	nil
vid.me	nil
psychologytoday.com	none	self
17k.com	nil
mightytext.net	nil
softbank.jp	nil
ofertasaxtel.mx	nil
nj.com	nil
carsensor.net	nil
h2porn.com	nil
filgoal.com	nil
history.com	nil
seek.com.au	nil
google.ee	none	self:google
diigo.com	nil
newsmax.com	none	self
creditmutuel.fr	nil
service-public.fr	nil
huffingtonpost.co.uk	nil
sinaimg.cn	nil
leroymerlin.fr	nil
jvzoo.com	nil
the-binary-trader.biz	nil
skyscrapercity.com	nil
bmo.com	nil
bol.uol.com.br	nil
telegraf.com.ua	nil
cheapoair.com	nil
vulture.com	nil
akairan.com	nil
etnet.com.hk	nil
betradar.com	nil
charter.net	nil
bnpparibas.net	nil
ssa.gov	nil
tagesschau.de	nil
marvel.com	nil
suntimes.com	nil
ipeen.com.tw	nil
wisc.edu	nil
filmon-live.com	nil
business-standard.com	nil
trafficmonsoon.com	nil
venturebeat.com	nil
arcot.com	nil
ithome.com	nil
ae.com	nil
live2apps.com	nil
sportbox.ru	nil
tecmundo.com.br	nil
zanox.com	nil
so.com	nil
blogspot.nl	none	self:google
pcadvisor.co.uk	nil
wikimapia.org	nil
russianpost.ru	nil
fashionandyou.com	nil
mirtesen.ru	invalid
dmzj.com	nil
ford.com	nil
ingbank.pl	nil
sheknows.com	nil
sme.sk	nil
justjared.com	invalid
sopitas.com	nil
eurosport.fr	nil
campaign-archive2.com	nil
wapka.mobi	nil
explosm.net	nil
irecommend.ru	invalid
heureka.cz	nil
pornolab.net	nil
moi.gov.sa	nil
vmall.com	nil
caf.fr	nil
eluniverso.com	nil
toranoana.jp	nil
ccavenue.com	nil
dsrlte.com	nil
zaman.com.tr	nil
dxy.cn	nil
jxnews.com.cn	nil
dmoz.org	nil
echoroukonline.com	nil
10010.com	nil
seesaawiki.jp	nil
johnlewis.com	nil
searchenginejournal.com	nil
filmesonlinegratis.net	nil
rutube.ru	invalid
ponparemall.com	nil
symantec.com	none	self,returnpath
extra.com.br	nil
incruit.com	nil
zeroredirect2.com	nil
icbc.com.cn	nil
sputniknews.com	nil
usgs.gov	nil
alriyadh.com	nil
runetki.com	nil
ggpht.com	reject	self:google
wmtransfer.com	nil
addmefast.com	nil
coolmath-games.com	nil
elbotola.com	nil
clicrbs.com.br	nil
islamweb.net	nil
vz.ru	nil
healthgrades.com	nil
debate.com.mx	nil
ibtimes.co.in	nil
lcl.fr	nil
webry.info	nil
gravatar.com	quarantine	dmarcian
enha.kr	nil
ccb.com.cn	nil
allmusic.com	nil
lastampa.it	nil
userscloud.com	nil
tchibo.de	nil
logmein.com	reject	agari,self
mathrubhumi.com	nil
euro-millionaire-system.com	nil
google.com.cu	none	self:google
copyscape.com	nil
theknot.com	nil
blackberry.com	nil
keywordblocks.com	nil
bridaltune.com	nil
caribbeancom.com	nil
sonyentertainmentnetwork.com	nil
wmaraci.com	nil
summotorrent.com	nil
pex.jp	nil
umn.edu	nil
ifttt.com	nil
almubasher.com.sa	nil
whirlpool.net.au	nil
justanswer.com	nil
rawstory.com	nil
songspk.link	nil
lofter.com	nil
w3school.com.cn	nil
wpengine.com	nil
all.biz	nil
elevenia.co.id	nil
korrespondent.net	nil
delicious.com	nil
opensooq.com	none	self
toyokeizai.net	nil
sbisec.co.jp	nil
ghanaweb.com	nil
isna.ir	nil
bigfishgames.com	nil
inps.it	nil
gruposantander.es	nil
polygon.com	nil
sendspace.com	none	self
repelis.tv	nil
mitbbs.com	nil
cpmrocket.com	nil
bluegape.com	nil
quicksprout.com	nil
here.com	nil
lvmama.com	nil
wenxuecity.com	nil
desidime.com	nil
marksandspencer.com	nil
mamba.ru	nil
torchbrowser.com	nil
papajohns.com	nil
smashingmagazine.com	nil
cmpms.com	nil
cldrlk.com	nil
postseek.com	nil
wufoo.com	none	returnpath,self
likesgag.com	nil
nps.gov	nil
nwgktl.com	nil
cox.com	nil
jang.com.pk	nil
natwest.com	nil
thetimingsystem.com	nil
govome.com	nil
redbubble.com	nil
express.com.pk	nil
pepperfry.com	nil
someecards.com	none	self
univision.com	nil
francetvinfo.fr	nil
hinet.net	nil
codeplex.com	nil
final.ir	nil
mizuhobank.co.jp	nil
gtbank.com	none	returnpath
laposte.fr	nil
51auto.com	nil
one.com	none	dmarcian
anandtech.com	nil
tripod.com	nil
ntv.com.tr	nil
bongda88.info	nil
santabanta.com	nil
walla.co.il	nil
google.ba	reject	self:google
id.net	invalid
flashx.tv	nil
livescience.com	nil
cas.sk	nil
epicurious.com	nil
itv.com	nil
trade.tmall.com	nil
wolframalpha.com	nil
televisa.com	nil
addtoany.com	nil
luxtarget.com	nil
concursolutions.com	nil
gizmodo.jp	nil
chinanews.com	nil
3158.cn	nil
dnsrsearch.com	nil
dek-d.com	nil
svqdys.com	nil
drakulastream.eu	nil
vrgmwz.com	nil
vogue.com.tw	nil
nab.com.au	nil
huawei.com	nil
ohozaa.com	nil
iconfinder.com	nil
banvenez.com	nil
elle.com	nil
couchsurfing.com	none	returnpath,self
591.com.tw	nil
biblehub.com	nil
neimanmarcus.com	nil
pornoxo.com	nil
panoramio.com	none	self:google
imagevenue.com	nil
tiu.ru	nil
illinois.edu	nil
gelocal.it	nil
creativebloq.com	nil
pitchfork.com	nil
smrtgs.com	nil
utorrent.com	nil
porndig.com	nil
lazada.co.th	nil
boingboing.net	nil
findagrave.com	nil
eazel.com	nil
atpanel.com	nil
wyborcza.pl	nil
zcool.com.cn	nil
eleconomista.es	nil
truecaller.com	nil
mos.ru	nil
brtn.cn	nil
mydealz.de	nil
sportskeeda.com	nil
gulfup.com	nil
kotobank.jp	nil
goibibo.com	nil
ya.ru	nil
bbt.com	nil
plugrush.com	nil
netsuite.com	nil
iheart.com	nil
ebscohost.com	nil
bloomingdales.com	nil
forocoches.com	nil
tbs.co.jp	nil
literotica.com	nil
ellechina.com	nil
ezinearticles.com	nil
campaign-archive1.com	nil
ahram.org.eg	nil
mapion.co.jp	nil
wonderfuldailygalleries.net	nil
slidesharecdn.com	nil
fengyunzhibo.com	nil
scol.com.cn	nil
gazzetta.gr	nil
extremetube.com	nil
craftsy.com	nil
playboy.com	nil
knowyourmeme.com	nil
vector.co.jp	nil
s1979.com	nil
payoneer.com	nil
sfglobe.com	invalid
shitaraba.net	nil
xitek.com	nil
clickpoint.com	nil
nasdaq.com	nil
panasonic.com	nil
blu-ray.com	nil
vidbull.com	nil
cyberciti.biz	nil
banglanews24.com	nil
saavn.com	nil
rankingsandreviews.com	nil
animaljam.com	nil
convert2mp3.net	nil
lagaceta.com.ar	none	dmarcian
iltasanomat.fi	nil
kaiserpermanente.org	none	agari,returnpath
prom.ua	nil
grammarly.com	nil
estadao.com.br	nil
perfectgirls.net	nil
zdf.de	nil
origo.hu	nil
stuff.co.nz	nil
foozine.com	nil
navyfederal.org	nil
bbva.es	nil
tripadvisor.es	nil
funnyjunk.com	nil
liansuo.com	nil
gidonline.club	nil
pbskids.org	nil
iqoption.com	nil
rabobank.nl	none	self
divyabhaskar.co.in	nil
xossip.com	nil
index.hr	nil
monsterindia.com	nil
alaraby.co.uk	nil
ucdavis.edu	nil
monotaro.com	nil
draugiem.lv	nil
jiji.com	nil
archdaily.com	nil
tintt.net	nil
ingdirect.es	quarantine	self
egotastic.com	nil
asg.to	nil
booloo.com	nil
tempo.co	nil
goodsearch.com	nil
camplace.com	monitor	self
angel.co	nil
99114.com	nil
google.com.sv	none	self:google
fetishshrine.com	nil
demotywatory.pl	invalid
sanspo.com	nil
cibc.com	nil
abola.pt	nil
oursogo.com	nil
chooseauto.com.cn	nil
banquepopulaire.fr	nil
hola.com	nil
ebrun.com	nil
spokeo.com	nil
rentalcars.com	none	returnpath
rae.es	nil
sevenforums.com	nil
seriouseats.com	invalid
90min.com	nil
shinobi.jp	nil
brainjet.com	nil
vivo.com.br	nil
www.net.cn	nil
scottrade.com	nil
collegeboard.org	nil
newsit.gr	nil
wikibooks.org	nil
newsru.com	nil
okta.com	reject	dmarcian
yle.fi	nil
republika.co.id	nil
sciencedaily.com	nil
cuny.edu	nil
giga.de	nil
marmiton.org	nil
xl.pt	nil
phoenixads.co.in	nil
mgpyh.com	nil
groupon.co.in	none	self,agari
ucweb.com	nil
macromill.com	nil
chouftv.ma	nil
topky.sk	nil
commerzbank.de	nil
news-us.jp	nil
jjwxc.net	nil
icook.tw	nil
alfabank.ru	nil
jal.co.jp	nil
gogetlinks.net	invalid
anipo.jp	nil
ameritrade.com	nil
prestashop.com	nil
holidaycheck.de	nil
tympanus.net	nil
simplyhired.com	none	
kotak.com	nil
trustpilot.com	reject	self
suruga-ya.jp	nil
resultados-futbol.com	nil
fanboyreport.com	nil
beeline.ru	nil
finishline.com	nil
jandan.net	nil
camdolls.com	nil
trovaprezzi.it	nil
whatculture.com	nil
olx.pt	invalid
dailydot.com	nil
anonym.to	nil
boardgamegeek.com	nil
mindbodyonline.com	nil
oxybe.com	nil
usda.gov	nil
upenn.edu	nil
gamingwonderland.com	nil
centurylink.com	none	dmarcian
wowkeren.com	nil
tubeplus.is	nil
bfmtv.com	nil
resellerclub.com	nil
overdrive.com	nil
sssc.cn	nil
local.com	nil
kwejk.pl	nil
sat.gob.mx	nil
lolking.net	nil
eater.com	nil
rincondelvago.com	nil
blogmura.com	nil
youngcons.com	nil
wonderhowto.com	nil
expireddomains.net	invalid
va.gov	nil
mobafire.com	nil
pornhd.com	nil
societe.com	nil
showroomprive.com	quarantine	returnpath
bancsabadell.com	nil
free-av-douga.com	nil
olx.com.pk	invalid
bongda60.com	nil
shoutmeloud.com	nil
bankmandiri.co.id	nil
uninstallmaster.com	nil
elcorteingles.es	nil
jutarnji.hr	nil
clubic.com	nil
boots.com	nil
linkeyproject.com	nil
juegos.com	nil
blick.ch	nil
pcauto.com.cn	nil
vic.gov.au	nil
thethao247.vn	nil
actcorp.in	nil
gamefactory.jp	nil
canalblog.com	nil
nationwide.co.uk	nil
tvtropes.org	nil
verycd.com	nil
cargurus.com	nil
bouyguestelecom.fr	nil
llbean.com	nil
freshdesk.com	invalid
lastpass.com	none	self
tweakers.net	nil
joyme.com	nil
mathworks.com	nil
camster.com	nil
ulta.com	invalid
landsend.com	nil
yammer.com	quarantine	returnpath
zoominfo.com	nil
visualstudio.com	nil
comdirect.de	nil
freenet.de	nil
xiu.com	nil
smitela.com	nil
bsnl.in	nil
zoznam.sk	nil
citilink.ru	nil
mercadolibre.com.co	nil
un.org	nil
uloz.to	invalid
beitaichufang.com	nil
tradedoubler.com	nil
mediamarkt.de	nil
search-simple.com	nil
duga.jp	nil
myfonts.com	nil
linkshrink.net	nil
laredoute.fr	nil
appbank.net	nil
who.int	nil
hkgolden.com	nil
amtrak.com	nil
telekom.de	nil
36kr.com	nil
coolenjoy.net	nil
tradeindia.com	nil
comenity.net	nil
travelzoo.com	none	returnpath
hyatt.com	nil
familysearch.org	nil
paginegialle.it	nil
oanda.com	nil
linguee.fr	nil
bama.ir	nil
morningstar.com	nil
discovery.com	nil
imageshack.com	nil
rusvesna.su	nil
seloger.com	none	dmarcian
buenastareas.com	nil
tubegalore.com	nil
radaronline.com	nil
khabarfarsi.com	nil
exist.ru	nil
fixya.com	none	self
crhoy.com	nil
sidecubes.com	nil
ucsd.edu	nil
rtbpopd.com	invalid
expressen.se	nil
malltail.com	nil
goo-net.com	nil
mt.co.kr	nil
almaany.com	nil
freshbooks.com	invalid
htc.com	nil
aufeminin.com	nil
coupang.com	nil
torrenthound.com	nil
oricon.co.jp	nil
bostonglobe.com	nil
lohaco.jp	nil
cqmama.net	nil
vidvib.com	nil
lotte.com	nil
tupaki.com	nil
wanyh.com	invalid
51hejia.com	nil
google.com.uy	none	self:google
ekstrabladet.dk	nil
guancha.cn	nil
homes.com	nil
unilad.co.uk	nil
wa.gov	nil
chengdu.cn	nil
lloydsbank.com	reject	agari
lostfilm.tv	nil
sweetim.com	nil
minecraft.net	nil
punchng.com	nil
vietnamnet.vn	nil
qatarairways.com	nil
sport24.gr	nil
futhead.com	nil
saksfifthavenue.com	nil
mirrorcreator.com	nil
e-estekhdam.com	nil
talktalk.co.uk	none	returnpath,unknown:acoppock@talktalkplc.com
thinkgeek.com	nil
snopes.com	nil
harborfreight.com	nil
harpersbazaar.com	nil
jumia.com.eg	nil
nwolb.com	nil
ovh.com	nil
payscale.com	nil
windowscentral.com	nil
aktuality.sk	nil
nzherald.co.nz	nil
deadline.com	invalid
agenciatributaria.gob.es	nil
jmw.com.cn	nil
lamoda.ru	nil
watchcartoononline.com	nil
flippa.com	nil
thestar.com	nil
yourlust.com	nil
nontonmovie.com	nil
kommersant.ru	nil
btspread.com	nil
coneco.net	nil
rantlifestyle.com	nil
get-a-fuck-tonight.com	nil
sleazyneasy.com	nil
vanityfair.com	nil
afkarnews.ir	nil
gizmag.com	nil
bestbuy.ca	nil
dose.com	nil
ssconline.nic.in	nil
navitime.co.jp	nil
segundamano.mx	nil
teacup.com	nil
tinydeal.com	nil
cic.gc.ca	nil
oxforddictionaries.com	nil
tusfiles.net	nil
spiceworks.com	nil
qoo10.sg	nil
oi.com.br	nil
streaming-illimite.net	nil
dasoertliche.de	nil
1hai.cn	nil
mentalk.com.cn	nil
blesk.cz	nil
asiae.co.kr	nil
gmanetwork.com	nil
yummly.com	nil
paipai.com	nil
cafepress.com	nil
cb01.eu	nil
thinkprogress.org	nil
elcomercio.com	nil
realitykings.com	nil
autov.com.cn	nil
meinestadt.de	nil
prnewswire.com	nil
drfileny.com	nil
canon.com	nil
flaticon.com	nil
superjob.ru	invalid
linguee.de	nil
modcloth.com	nil
turkishairlines.com	nil
twitcasting.tv	nil
downloadcobol.com	nil
bet-at-home.com	nil
p30download.com	nil
netvibes.com	nil
mk.co.kr	nil
edmodo.com	nil
immowelt.de	nil
huffingtonpost.fr	nil
storypick.com	nil
bancobrasil.com.br	nil
metafilter.com	nil
my-hit.org	nil
babyblog.ru	invalid
mapsgalaxy.com	nil
journaldesfemmes.com	nil
squareup.com	nil
hbr.org	nil
tomtom.com	nil
cuevana2.tv	nil
ebaumsworld.com	nil
atlassian.com	nil
tvline.com	nil
koreastardaily.com	nil
ivc.cn	nil
mywebsearch.com	nil
sf-express.com	nil
wn.com	nil
mango.com	nil
onlinedown.net	nil
fararu.com	nil
list-manage2.com	invalid
eltiempo.es	nil
bakufu.jp	nil
sky.de	nil
sagepub.com	nil
abv.bg	nil
bet365.es	quarantine	self
fdrmx.com	nil
honda.com	nil
e1.ru	invalid
cri.cn	nil
androidauthority.com	nil
metroer.com	nil
christian-dogma.com	nil
technet.com	nil
adnxs.com	nil
taikang.com	nil
xero.com	none	agari
easybib.com	nil
pr-cy.ru	nil
finanzen.net	nil
miralinks.ru	nil
digitalspy.co.uk	nil
dntrax.com	nil
dtiblog.com	nil
buyvip.com	nil
awesomeinventions.com	none	self
exhentai.org	nil
kariyer.net	none	
searchlock.com	nil
ad127m.com	nil
bestairboattours.com	nil
obozrevatel.com	nil
turnitin.com	nil
5dcar.com	nil
fullonlinefilmizle.com	nil
mp3skull.to	nil
iobit.com	nil
google.com.gh	none	self:google
sky.it	nil
expansion.com	nil
about.me	none	messagebus
khamsat.com	nil
lufthansa.com	nil
ad124m.com	nil
baltimoresun.com	nil
kolesa.kz	none	
katestube.com	nil
opendns.com	nil
searchenginewatch.com	nil
autoscout24.it	nil
mediametrics.ru	nil
todoist.com	nil
hangame.co.jp	nil
jofogas.hu	nil
bravotube.net	nil
sport-express.ru	nil
lomadee.com	nil
agame.com	nil
vodoumedia.com	nil
downloaddart.com	nil
thedishh.com	nil
tosarang.net	nil
myvidster.com	nil
imore.com	nil
mehrnews.com	nil
incredibar.com	nil
ipko.pl	nil
usembassy.gov	nil
baskino.com	nil
pcstore.com.tw	nil
href.li	nil
medu.ir	nil
jz123.cn	nil
fudan.edu.cn	nil
banki.ru	quarantine	self
vista.ir	nil
malwarebytes.org	nil
lan.com	nil
directadvert.ru	nil
9to5mac.com	invalid
thepiratebay.la	nil
mk.ru	nil
surveymyopinion.com	nil
mindbodygreen.com	nil
accenture.com	nil
aftenposten.no	nil
jobsdb.com	invalid
instantcheckmate.com	nil
nsw.gov.au	nil
3dwwwgame.com	nil
subscribe.ru	none	self
espnfc.us	nil
iefimerida.gr	nil
military38.com	nil
provincial.com	nil
buynow.com.cn	nil
ing-diba.de	reject	unknown:ing-diba@dmarc.monitoring.cyscon.de,unknown:forensic.ingdiba@dmarc.monitori
intellicast.com	nil
in.gr	nil
suddenlylikablepix.net	nil
dafapromo.com	nil
independent.ie	nil
philly.com	nil
kxcdn.com	nil
whatismyipaddress.com	nil
kurir.rs	nil
solarmovie.ws	nil
indonesia-community.net	nil
bigmir.net	nil
tro-ma-ktiko.blogspot.gr	nil
pcanalysis.net	nil
aplus.com	nil
1fichier.com	nil
nhaccuatui.com	nil
anthropologie.com	nil
inbox.lv	quarantine	self
sbicard.com	nil
dpstream.net	nil
mheducation.com	nil
libraryreserve.com	nil
usairways.com	nil
passportindia.gov.in	nil
livejournal.biz	nil
ideacellular.com	nil
ornacorn.com	nil
chow.com	nil
ibnlive.com	nil
mensfitness.com	nil
homeshop18.com	nil
viator.com	nil
ttmeiju.com	nil
tikona.in	nil
apartments.com	nil
sharelive.net	nil
joemonster.org	invalid
jetbrains.com	nil
yohoboys.com	nil
rstyle.me	nil
thomann.de	nil
oursurfing.com	nil
ntvspor.net	nil
plsdrct2.me	nil
marketgid.com	nil
gettyimages.com	nil
youniversalmedia.com	nil
chegg.com	nil
cumhuriyet.com.tr	nil
webhostingtalk.com	nil
pontofrio.com.br	nil
regions.com	nil
blogosfera.uol.com.br	nil
hirufm.lk	nil
wallpaperswide.com	nil
immobiliare.it	nil
unlimitedaffluence.com	nil
bbready.com	nil
smbc-card.com	nil
tvrain.ru	nil
githubusercontent.com	nil
jobvite.com	nil
uiuc.edu	nil
readthedocs.org	nil
vonvon.me	nil
dytt8.net	nil
jetstar.com	nil
cra-arc.gc.ca	nil
pptv.com	nil
skrill.com	reject	returnpath
usajobs.gov	nil
ilaiki.net	nil
cairodar.com	nil
socialmediaexaminer.com	invalid
07073.com	nil
yieldtraffic.com	nil
iptorrents.com	nil
flightaware.com	nil
bungie.net	none	unknown:dmarcreports@bungie.com
cankaoxiaoxi.com	nil
ad.nl	nil
mxtoolbox.com	nil
playxn.com	nil
appnexus.com	nil
ltmmty.com	nil
tandfonline.com	nil
provinet.net	nil
nos.nl	nil
direct.gov.uk	nil
tiexue.net	nil
skycn.com	nil
royalmail.com	none	agari
fotocasa.es	nil
freepornvs.com	nil
casasbahia.com.br	nil
ajanshaber.com	nil
nissen.co.jp	nil
myvideo.de	nil
jiayuan.com	nil
michaels.com	nil
nuomi.com	nil
yohogirls.com	nil
bonprix.de	nil
fivethirtyeight.com	invalid
torrentfreak.com	nil
craftsvilla.com	nil
washingtontimes.com	nil
next.co.uk	nil
outlook.com	none	agari,returnpath
minecraftforum.net	nil
news247.gr	nil
adidas.com	nil
nyc.gov	nil
blankrefer.com	nil
wish.com	nil
imgga.com	nil
ubi.com	nil
cncn.org.cn	nil
vanguardngr.com	nil
marthastewart.com	invalid
rueducommerce.fr	nil
finalfantasyxiv.com	nil
infowars.com	nil
niusnews.com	nil
watchseries.ag	nil
rivals.com	none	self:yahoo
hotchatdate.com	nil
zemtv.com	nil
trustedreviews.com	nil
ppstream.com	nil
imgtiger.com	nil
vitacost.com	nil
odesk.com	nil
viralmundo.nl	nil
enterprise.com	nil
huffingtonpost.jp	nil
ricardo.ch	nil
naughtyamerica.com	nil
lepoint.fr	nil
luckysearches.com	nil
tasteofhome.com	nil
nat.gov.tw	nil
video2mp3.net	nil
bazos.sk	nil
arcor.de	nil
name.com	nil
pixhost.org	nil
agenciatributaria.es	nil
liepin.com	nil
menshealth.com	nil
dwnews.com	nil
kkbox.com	nil
alc.co.jp	nil
asda.com	nil
tnt-online.ru	nil
toshiba.com	nil
diy.com	nil
homes.co.jp	nil
bradsdeals.com	nil
derstandard.at	nil
deseretnews.com	nil
news.cn	nil
thepennyhoarder.com	nil
googlevideo.com	none	self:google
canalrcn.com	nil
lowyat.net	nil
99designs.com	quarantine	dmarcian
mylust.com	nil
jra.go.jp	nil
kaidee.com	nil
aliimg.com	nil
247sports.com	invalid
ratemyprofessors.com	nil
bangbros.com	invalid
packagetrackr.com	nil
clickjogos.com.br	nil
identi.li	nil
uploadboy.com	nil
aaa.com	nil
businessinsider.in	invalid
5usport.com	nil
honda.co.jp	nil
locanto.in	nil
nur.kz	nil
seneweb.com	nil
opposingviews.com	nil
nvidia.com	nil
potterybarn.com	nil
stardoll.com	nil
feedburner.com	none	self:google
51.la	nil
olleh.com	nil
bitecharge.com	nil
acesso.uol.com.br	nil
pandora.tv	invalid
hmv.co.jp	nil
freecharge.in	nil
care2.com	nil
poncan.jp	nil
guang.com	nil
amd.com	invalid
sammobile.com	nil
92lux.cn	nil
ad131m.com	nil
sdyqr198dchnw7194n.com	nil
plex.tv	nil
opencart.com	nil
csfd.cz	nil
openlinkprofiler.org	nil
mysearchresults.com	nil
pearsoncmg.com	nil
alsotube.com	nil
bigrock.in	nil
printvenue.com	nil
abnamro.nl	none	returnpath,unknown:dmarc@nl.abnamro.com
ozztube.com	nil
go2000.com	nil
ifixit.com	nil
addictinggames.com	nil
menards.com	nil
payseal.com	nil
khabarpu.com	nil
enuri.com	nil
siriusxm.com	nil
dhc.co.jp	nil
shiftdelete.net	nil
gougou.com	nil
freewebcams.com	nil
alaan.tv	nil
vatgia.com	nil
starbaby.cn	nil
mobile.ir	nil
lotteimall.com	nil
20min.ch	nil
withgoogle.com	none	self:google
30daychange.co	nil
timetobreak.com	nil
bongdainfo.com	nil
hautelook.com	nil
videolan.org	nil
rimanews.com	nil
90tv.ir	nil
shabdkosh.com	nil
zimuzu.tv	nil
magentocommerce.com	nil
einfachporno.com	nil
bellemaison.jp	nil
bazos.cz	nil
viki.com	nil
vtv.vn	nil
ctvnews.ca	nil
qoo10.jp	nil
with2.net	nil
cloud-trax.com	nil
google.com.qa	none	self:google
gnc.com	nil
camelcamelcamel.com	nil
linio.com.co	nil
scout.com	nil
aad73c550c.se	nil
b92.net	nil
classmates.com	none	returnpath,self
makeleio.gr	nil
sexuhot.com	nil
videohive.net	nil
vidto.me	nil
docstoc.com	nil
blog.hu	nil
izlesene.com	nil
niksalehi.com	nil
excelsior.com.mx	nil
on.cc	nil
blastingnews.com	nil
filmaffinity.com	nil
ipsosinteractive.com	nil
ovh.net	nil
standardbank.co.za		
duomai.com	nil
ad134m.com	nil
blogspot.ro	none	self:google
megafon.ru	nil
cnnturk.com	nil
centrum24.pl	nil
thestar.com.my	nil
sankakucomplex.com	nil
net-a-porter.com	nil
mappy.com	nil
redhat.com	nil
isbank.com.tr	reject	self
streamin.to	nil
ivi.ru	nil
yepme.com	nil
geforce.com	nil
gamerch.com	nil
popularmechanics.com	nil
magazineluiza.com.br	nil
acunn.com	nil
xsrv.jp	nil
nordstromrack.com	nil
usc.edu	nil
decolar.com	nil
infibeam.com	nil
patreon.com	nil
yifysubtitles.com	nil
91jm.com	nil
tianji.com	nil
shmoop.com	nil
n156adserv.com	nil
invisionapp.com	nil
lagou.com	nil
canalplus.fr	nil
thairath.co.th	nil
daraz.pk	nil
videostripe.com	nil
footlocker.com	nil
motor-talk.de	nil
ojooo.com	nil
xingpin.com	nil
linksynergy.com	nil
worldlifestyle.com	nil
yourstory.com	nil
th3professional.com	nil
dumpert.nl	nil
google.com.bh	none	self:google
gfsoso.net	nil
domain.com.au	nil
uservoice.com	invalid
strtpoint.com	nil
hixgo.com	nil
tsn.ca	nil
sports747.com	nil
ea3w.com	nil
avenues.info	nil
livemook.com	nil
holiday-weather.com	nil
megashare.sc	nil
dnb.no	nil
shihuo.cn	nil
comicbookresources.com	nil
ziprecruiter.com	nil
dhs.gov	nil
strawberrynet.com	nil
dzone.com	nil
heavy-r.com	nil
carmax.com	nil
atresplayer.com	nil
womenshealthmag.com	nil
autotimes.com.cn	nil
walmart.ca	nil
120ask.com	nil
rantsports.com	nil
babbel.com	nil
yu0123456.com	nil
teacherspayteachers.com	nil
saraiva.com.br	nil
dota2.com	nil
upwatch.com	nil
jobandtalent.com	nil
yonhapnews.co.kr	nil
browsersfeedback.com	nil
opera.com	nil
bbandt.com	nil
irib.ir	nil
alternativeto.net	nil
fotor.com	nil
thevideo.me	nil
goodhousekeeping.com	nil
eldiario.es	nil
chinaunix.net	nil
foundationapi.com	nil
perfectmoney.is	nil
weightwatchers.com	nil
drazens.com	nil
hizliresim.com	nil
britannica.com	nil
ninemsn.com.au	nil
aproductmsg.com	nil
mql5.com	nil
scholastic.com	nil
mediatakeout.com	nil
conrad.de	nil
ehanex.com	nil
docomo.ne.jp	nil
oneplus.net	nil
hln.be	nil
groupon.it	none	self,agari
teddybrinkofski.com	nil
animeflv.net	nil
filelist.ro	nil
rotoworld.com	nil
saudiairlines.com	nil
interfax.ru	nil
akb48matomemory.com	nil
backcountry.com	nil
omegle.com	nil
mouthshut.com	nil
bidorbuy.co.za	none	self
infolinks.com	nil
reed.co.uk	nil
rai.it	nil
getsidekick.com	nil
pop-music.ir	nil
sanalpazar.com	nil
downloadha.com	nil
baihe.com	nil
juntadeandalucia.es	nil
teamtreehouse.com	nil
hardwarezone.com.sg	nil
heavy.com	nil
shoplocal.com	nil
aragontrack.com	nil
woorank.com	nil
sc.com	none	self
bsnl.co.in	nil
bobaedream.co.kr	nil
52pk.net	nil
immonet.de	nil
pirateproxy.sx	nil
girlsgogames.com	nil
cloudapp.net	nil
blogos.com	nil
suggest.com	nil
bintang.com	nil
78.cn	nil
cmu.edu	nil
abchina.com	nil
successfactors.com	nil
gucheng.com	nil
therichest.com	nil
esquire.com	nil
hattrick.org	nil
optimum.net	nil
emag.ro	nil
umd.edu	nil
aol.co.uk	none	agari
skybet.com	nil
wikiwand.com	nil
cy-pr.com	nil
thomsonreuters.com	nil
kroger.com	nil
coolsocialsearch.com	nil
cjmall.com	nil
adk2.com	nil
andhrajyothy.com	nil
freep.com	nil
olx.co.za	nil
yepi.com	nil
definicion.de	nil
idol-blog.com	nil
forumfree.it	nil
hotelurbano.com	nil
solidfiles.com	none	self
encuentra24.com	nil
ele.me	nil
dict.cn	nil
turkiye.gov.tr	nil
economia.uol.com.br	nil
testberichte.de	nil
google.com.np	none	self:google
egypttoday.co.uk	nil
cowboom.com	nil
realtor.ca	nil
1digitalstock.com	nil
uniblue.com	nil
khan.co.kr	nil
nseindia.com	nil
smallpdf.com	nil
google.co.tz	none	self:google
privat24.ua	nil
folkd.com	nil
wizards.com	nil
bankia.es	nil
yougou.com	nil
101xp.com	nil
wow-impulse.ru	nil
ngoisao.net	nil
woman.ru	nil
warning.or.kr	nil
mr-guangdong.com	nil
elespectador.com	nil
channel4.com	nil
sagawa-exp.co.jp	nil
etonline.com	nil
qyer.com	nil
dailypakistan.com.pk	nil
tamin.ir	nil
tripadvisor.de	nil
tomshardware.co.uk	nil
thedailytrader.net	nil
farfesh.com	nil
imgbox.com	nil
depositfiles.com	nil
mmgp.ru	nil
wmmail.ru	nil
ria.com	nil
saisoncard.co.jp	invalid
cwtv.com	nil
aif.ru	invalid
manualslib.com	nil
vatanim.com.tr	nil
inoreader.com	nil
maalaimalar.com	nil
dealdey.com	nil
zamzar.com	none	self
standardchartered.com	nil
huffingtonpost.ca	nil
hammihan.com	nil
qualitychecker.net	nil
fast-torrent.ru	nil
2dbook.com	nil
internet-positif.org	nil
mlive.com	nil
rpp.com.pe	nil
curse.com	nil
euronews.com	nil
gg.com.ua	nil
adk2x.com	nil
governmentjobs.com	nil
qtrax.com	nil
ruelala.com	nil
ixbt.com	nil
tvnet.lv	nil
mapsofindia.com	nil
yify-torrent.org	nil
click.in	nil
utarget.ru	nil
home.pl	nil
clip.vn	nil
globaltimes.cn	nil
ouest-france.fr	nil
delfi.lv	nil
santander.com.br	nil
mybroadband.co.za	nil
tfl.gov.uk	nil
digadz.com	nil
sbs.co.kr	nil
netcoc.com	nil
brobible.com	nil
computerhope.com	nil
publishthis.com	nil
groupon.co.uk	none	self,agari
aukro.cz	nil
jtads.info	nil
tvmuse.com	invalid
smbc.co.jp	nil
citenkomedia.com	nil
hapitas.jp	nil
po-kaki-to.com	nil
jeu.info	nil
worldcat.org	nil
dkb.de	nil
dmhy.org	nil
footmercato.net	nil
research-panel.jp	nil
dailycaller.com	nil
sbi.co.in	nil
aicheren.com	nil
walkerplus.com	nil
nowvideo.li	nil
e-rewards.com	nil
muyzorras.com	nil
canadiantire.ca	nil
google.co.ke	none	self:google
princeton.edu	nil
elheddaf.com	nil
ponta.jp	nil
k2s.cc	nil
xiaomi.cn	nil
yes24.com	nil
liberation.fr	nil
fengniao.com	nil
vivanuncios.com.mx	nil
holidayiq.com	nil
ilmessaggero.it	nil
macworld.com	nil
stepstone.de	nil
takealot.com	nil
isohunt.to	nil
confirmit.com	nil
sedo.com	nil
eldorado.ru	nil
esy.es	nil
jorudan.co.jp	nil
planetsuzy.org	invalid
manhunt.net	nil
dramafever.com	nil
acrobat.com		
inbox.com	nil
lolesports.com	nil
tcafex.com	nil
sheinside.com	nil
metacafe.com	nil
jcb.co.jp	nil
google.com.kh	none	self:google
geocaching.com	nil
bancoestado.cl	nil
cbseresults.nic.in	nil
mysurvey.com	nil
ufl.edu	nil
zalukaj.tv	nil
fhserve.com	nil
15min.lt	nil
deccanchronicle.com	nil
persiangig.com	nil
sinoptik.ua	nil
pons.com	nil
alaskaair.com	nil
tvzvezda.ru	nil
zakzak.co.jp	nil
hidemyass.com	nil
intesasanpaolo.com	nil
olx.com.ve	nil
svyaznoy.ru	invalid
msu.edu	nil
91mobiles.com	nil
fzg360.com	nil
gardenweb.com	nil
androidpit.com	nil
petsmart.com	nil
vivastreet.com	nil
buhidoh.net	nil
imgserve.net	nil
1800option.com	nil
espn.uol.com.br	nil
freevideo.cz	nil
blockchain.info	quarantine	self
theregister.co.uk	nil
warthunder.ru	nil
fark.com	nil
ganool.com	nil
oriflame.com	nil
boredomtherapy.com	nil
hearthpwn.com	nil
statefarm.com	nil
vikiporn.com	nil
storify.com	nil
misli.com	nil
ameli.fr	nil
stargames.com	nil
360kan.com	nil
pgatour.com	nil
qip.ru	nil
google.lu	reject	self:google
farfetch.com	nil
klout.com	nil
surveygizmo.com	nil
fiuxy.com	nil
financialexpress.com	nil
lastminute.com	nil
dsw.com	nil
arabiaweather.com	nil
bom.gov.au	nil
malaysiakini.com	nil
tutu.ru	nil
asianews2ch.jp	nil
clicksor.com	nil
smbc-comics.com	nil
snagajob.com	nil
nick.com	nil
main.jp	nil
paper.li	nil
tdcanadatrust.com	nil
advertzer.com	nil
addictinginfo.org	nil
3dnews.ru	nil
westeros.org	nil
dafiti.com.br	nil
ighome.com	nil
reliancenetconnect.co.in	nil
collective-evolution.com	nil
beatport.com	nil
ku6.com	nil
chachagong5.com	nil
tiboo.cn	nil
parperfeito.com.br	nil
bola.net	nil
tickld.com	nil
vdoobv.com	nil
obdesign.com.tw	nil
pointtown.com	nil
uwants.com	invalid
akiba-online.com	nil
cathaypacific.com	nil
labirint.ru	nil
ngs.ru	nil
aktualne.cz	nil
j.gs	nil
joyclub.de	invalid
jeevansathi.com	nil
petardas.com	nil
groupon.jp	none	self,agari
promopro.com	invalid
comicvine.com	nil
mamaclub.com	nil
zhanqi.tv	nil
neteller.com	nil
myrecipes.com	nil
miomio.tv	nil
imageshack.us	nil
18183.com	nil
autozone.com	nil
fujitv.co.jp	nil
tatadocomo.com	nil
newlook.com	nil
ecuavisa.com	nil
wankoz.com	nil
chainreactioncycles.com	nil
wordstream.com	nil
204.12.226.68	nil
omniboxes.com	nil
ujipin.com	nil
seobook.com	nil
tribalwars2.com	nil
irr.ru	nil
mercadolibre.com	reject	dmarcian,dmarcanalyzer
syosetu.org	nil
secondlife.com	nil
eastbay.com	nil
19lou.com	nil
thepiratebay.am	nil
wittyfeed.com	nil
diamond.jp	nil
hankyung.com	nil
wizzair.com	nil
experts-exchange.com	nil
funda.nl	nil
ilgiornale.it	nil
themalaysianinsider.com	nil
yemeksepeti.com	nil
hesport.com	nil
silkroad.com	nil
watchmygf.net	nil
castorama.fr	nil
advfn.com	invalid
elaosboa.com	nil
musiciansfriend.com	nil
kabum.com.br	nil
olx.kz	nil
papystreaming.com	nil
flyertalk.com	nil
myplaycity.com	nil
sherdog.com	nil
chatwork.com	nil
ally.com	none	self,dmarcian
tamu.edu	nil
calameo.com	nil
56.com	nil
gayboystube.com	nil
gopro.com	nil
dailysanctuary.com	nil
alabout.com	nil
watchseries.lt	nil
mail.uol.com.br	nil
telegram.org	invalid
dotabuff.com	nil
ad129m.com	nil
projectfreetv.so	nil
noticias24.com	nil
wikiquote.org	nil
origin.com	nil
easyhits4u.com	nil
hobbyking.com	nil
lifo.gr	nil
cairoportal.com	nil
sindonews.com	nil
allwomenstalk.com	nil
n149adserv.com	nil
entekhab.ir	nil
dn.se	nil
prevention.com	nil
ebates.kr	nil
teknoter.com	nil
team-bhp.com	nil
ajc.com	nil
chacha.com	nil
qihoo.com	nil
letitbit.net	nil
banamex.com.mx	none	agari,self
proflowers.com	nil
gismeteo.ua	nil
isp-survey.com	nil
huffingtonpost.it	nil
streamcomplet.com	nil
yale.edu	nil
buzzlamp.com	nil
zimbra.free.fr	nil
otzovik.com	nil
regnum.ru	nil
rozup.ir	nil
adschemist.com	invalid
eslamoda.com	nil
progressive.com	nil
rzd.ru	nil
questionablecontent.net	nil
dallasnews.com	nil
rakuten-sec.co.jp	nil
libertaddigital.com	nil
kanoon.ir	nil
yinyuetai.com	nil
worldoftanks.eu	nil
siteground.com	nil
couponfollow.com	nil
plotek.pl	nil
pornhublive.com	none	unknown:dmarc-reports@flyingcroc.net,unknown:dmarc-abuse-reports@flyingcroc.net
startpage.com	nil
eroticdatng.com	nil
royalgames.com	nil
skynewsarabia.com	nil
ebay.ie	none	agari,returnpath
mejortorrent.com	nil
vidtomp3.com	nil
wikidot.com	nil
adorama.com	nil
yaske.to	nil
majestic.com	none	self
xhamstercams.com	nil
taobaocdn.com	nil
grubhub.com	nil
ontits.com	nil
8264.com	nil
fs.to	nil
hosyusokuhou.jp	nil
3sk.tv	nil
jusbrasil.com.br	invalid
intelius.com	nil
auspost.com.au	none	returnpath
cam4ads.com	nil
53.com	nil
indiapost.gov.in	nil
lancenet.com.br	nil
metric-conversions.org	nil
jkforum.net	nil
pagseguro.uol.com.br	nil
javlibrary.com	nil
higherperspectives.com	nil
smartinf.ru	nil
absoluteclickscom.com	nil
giantbomb.com	nil
ultipro.com	nil
gulte.com	nil
lapresse.ca	nil
alamaula.com	nil
soha.vn	nil
thepetitionsite.com	nil
gouv.qc.ca	nil
xlovecam.com	nil
smartprix.com	nil
postads24.com	nil
iconarchive.com	nil
acs.org	nil
trafficserving.com	nil
allkpop.com	nil
bizrate.com	none	returnpath
mover.uz	nil
interstats.org	nil
society6.com	nil
518.com.tw	nil
intentmedia.net	nil
ml.com	none	unknown:auth.report_ns@bankofamerica.com
signupgenius.com	nil
philips.com	nil
freemail.hu	nil
srv2trking.com	nil
udacha.club	nil
msn.com.cn	nil
vatanbilgisayar.com	nil
peopleperhour.com	nil
tripadvisor.ca	nil
awwwards.com	nil
clickradio.me	nil
currys.co.uk	nil
mundosexanuncio.com	invalid
ozbargain.com.au	nil
porntheatres.com	nil
careers360.com	none	unknown:dmarc@nczc.asia
pc6.com	nil
petapixel.com	nil
24sata.hr	nil
tn.com.ar	nil
diaforetiko.gr	nil
joann.com	nil
eclipse.org	nil
lesechos.fr	nil
vod.pl	nil
fabfurnish.com	nil
cw.com.tw	nil
service.gov.uk	nil
udacity.com	nil
sbrf.ru	nil
cna.com.tw	nil
tribalfusion.com	nil
sourcenext.com	invalid
motorola.com	nil
ebayimg.com	nil
accorhotels.com	nil
mercadolibre.cl	nil
telerik.com	nil
bancodevenezuela.com	nil
fontspace.com	nil
freekaamaal.com	none	self
aa.com.tr	nil
beritasatu.com	nil
shareonion.com	nil
bakecaincontrii.com	nil
gusuwang.com	nil
alluc.com	nil
fanduel.com	nil
bbcgoodfood.com	nil
clickbank.net	nil
gendama.jp	nil
eharmony.com	nil
800notes.com	nil
polo.com	nil
gmx.at	nil
jobdiagnosis.com	nil
vodafone.it	nil
yandex.net	nil
asexstories.com	nil
mr-johal.com	nil
readms.com	nil
swiki.jp	nil
labnol.org	nil
dbs.com.sg	nil
laprensagrafica.com	nil
tribune.com.pk	nil
javpop.com	nil
maydany.com	nil
80018.cn	nil
movistar.es	nil
tfile.me	nil
newgrounds.com	quarantine	postmarkapp
eporner.com	reject	
seattletimes.com	nil
exploader.net	nil
biccamera.com	nil
indeed.fr	nil
flexmls.com	nil
tankionline.com	quarantine	self
kankan.com	nil
nintendo.co.jp	nil
kakao.com	nil
redflagdeals.com	nil
patient.co.uk	nil
dtlpx.com	nil
journaldunet.com	nil
viidii.info	nil
quotev.com	nil
suntory.co.jp	nil
golem.de	nil
epnet.com	nil
state.pa.us	nil
mobofree.com	nil
milenio.com	nil
homedepot.ca	nil
alternet.org	nil
pchouse.com.cn	nil
sofmap.com	nil
pmang.jp	nil
eelly.com	nil
n4g.com	nil
americanoverlook.com	nil
playerme.org	nil
top-channel.tv	nil
eurovision.tv	nil
parents.com	nil
hinkhoj.com	nil
thepiratebay.gd	nil
mercadopago.com	reject	dmarcian,dmarcanalyzer
worldbank.org	nil
dr.dk	nil
dy2018.com	nil
thepiratebay.mn	nil
perfil.com	nil
al.com	nil
paruvendu.fr	nil
googlegroups.com	none	self:google
gohappy.com.tw	nil
k12.ca.us	nil
adevarul.ro	nil
tre.it	nil
mid-day.com	nil
torrentbutler.eu	nil
blogspot.hk	none	self:google
appannie.com	none	self
myorderbox.com	nil
speedbit.com	nil
irishtimes.com	nil
networksolutions.com	nil
loft.com	nil
petco.com	nil
vogue.com	nil
absa.co.za	nil
mysynchrony.com	nil
gametop.com	nil
revenuehits.com	nil
lacentrale.fr	nil
rdio.com	nil
darty.com	nil
nationalrail.co.uk	nil
uspto.gov	nil
handelsblatt.com	nil
yapikredi.com.tr	none	self
mmafighting.com	nil
mako.co.il	nil
japannetbank.co.jp	nil
wpolityce.pl	nil
gogoanime.com	nil
getchu.com	nil
asu.edu	nil
337.com	nil
hankooki.com	nil
irna.ir	nil
vav.kr	nil
odatv.com	nil
abebooks.com	nil
almaghribtoday.net	nil
aol.de	none	agari
computerbase.de	none	
google.com.mm	reject	self:google
watchseries-online.ch	nil
klm.com	nil
khaosod.co.th	nil
kickasstorrents.to	nil
soy502.com	nil
icicidirect.com	nil
toluna.com	nil
voila.fr	nil
soft98.ir	nil
loc.gov	nil
dm5.com	nil
ikman.lk	nil
national.com.au	nil
geektimes.ru	nil
purepeople.com	nil
motherjones.com	nil
fdj.fr	nil
q.gs	nil
sport-fm.gr	nil
login.tmall.com	nil
jobomas.com	nil
swedbank.se	nil
google.com.py	reject	self:google
bluestacks.com	nil
mydocomo.com	nil
nocoty.pl	nil
ixl.com	nil
bigcommerce.com	nil
oregonlive.com	nil
nintendo.com	nil
google.com.ni	none	self:google
5giay.vn	nil
hostelworld.com	nil
herstage.com	nil
mrrebates.com	nil
j-cast.com	nil
alwatanvoice.com	nil
adorocinema.com	nil
njuskalo.hr	nil
computerworld.com	nil
minuto30.com	nil
blockthis.eu	nil
girlschannel.net	nil
static1.squarespace.com	nil
active.com	nil
shitaraba.com	nil
jreast.co.jp	nil
payback.de	reject	
disneystore.com	nil
bovada.lv	nil
ceskatelevize.cz	nil
4do.se	nil
mastercard.com.au	nil
comingsoon.net	nil
stripe.com	quarantine	agari,returnpath,self
trenitalia.com	nil
rp5.ru	nil
bannersdontwork.com	nil
ebay.at	none	agari,returnpath
paddypower.com	nil
baomoi.com	nil
debenhams.com	nil
bong99.com	nil
scientificamerican.com	nil
mafa.com	nil
bulbagarden.net	nil
eluniversal.com	nil
todo1.com	nil
marinetraffic.com	nil
newsweek.pl	nil
bobfilm.net	nil
adult-empire.com	invalid
torrentdownloads.me	nil
lenskart.com	none	unknown:abuse@utilityinbox.com
androidpolice.com	nil
podio.com	nil
bmail.uol.com.br	nil
tv2.no	nil
djelfa.info	nil
thegag.tv	nil
paginebianche.it	nil
touchofmodern.com	nil
telemundo.com	nil
zovi.com	nil
authorize.net	quarantine	returnpath
cpanel.net	none	self
softgozar.com	nil
moheet.com	nil
cyanogenmod.org	nil
forbes.ru	invalid
rutgers.edu	nil
bollywoodhungama.com	nil
copy.com	nil
dice.com	nil
startribune.com	nil
arabseed.com	nil
dmkt-sp.jp	nil
trafficshop.com	nil
zalando.it	nil
oxfordjournals.org	nil
saturn.de	nil
grabon.in	nil
goodforsearch.info	nil
care.com	invalid
corrieredellosport.it	nil
livemaster.ru	none	self
e-monsite.com	nil
petfinder.com	none	self
basecamphq.com	invalid
fcbarcelona.com	nil
yell.com	nil
v2ex.com	nil
gamestar.de	nil
secureopensoftware.com	nil
bitsnoop.com	nil
king.com	nil
dikaiologitika.gr	nil
capital.gr	nil
worldpay.com	nil
eurogamer.net	nil
hoolo.tv	nil
safeway.com	nil
kurir.mk	nil
tineye.com	nil
usearchmedia.com	nil
cheetahmail.com	invalid
shueisha.co.jp	nil
adobelogin.com	none	agari
metronews.fr	nil
zaobao.com	nil
lelong.com.my	nil
colissimo.fr	nil
unc.edu	nil
centurylink.net	none	unknown:dmarcrep@qwest.net
livemint.com	nil
slutroulette.com	invalid
dastelefonbuch.de	nil
fontsquirrel.com	nil
crateandbarrel.com	nil
thepiratebay.vg	nil
email.cz	nil
isimtescil.net	nil
talabat.com	nil
pornicom.com	nil
apartmentguide.com	none	dmarcian
asklaila.com	nil
a-q-f.com	nil
yan.vn	nil
fineartamerica.com	nil
sambaporno.com	nil
xtendmedia.com	nil
ennaharonline.com	nil
worldfree4u.com	nil
dion.ne.jp	nil
dailystar.co.uk	nil
xxxbunker.com	nil
javinn.com	nil
recruit.co.jp	nil
carters.com	nil
meetme.com	none\	unknown:dmarc@meetmemail.com
uchicago.edu	nil
w3layouts.com	nil
kyodo-d.jp	nil
persianv.com	nil
thumbtack.com	nil
topstoreoffers.com	nil
alphaporno.com	nil
beforeitsnews.com	nil
windguru.cz	nil
forumcommunity.net	invalid
planetminecraft.com	nil
gamesradar.com	nil
ziddu.com	nil
thehill.com	nil
mypoints.com	none\	unknown:dmarc_agg@auth.returnpath.net\,unknown:dmarc_afrf@auth.returnpath.net\
meetic.fr	none	returnpath,unknown:rua@emailing_admin.ilius.net,unknown:ruf@emailing_admin.ilius.net
camfrog.com	nil
muji.net	nil
nullpoantenna.com	nil
join.me	none	agari,unknown:dmarc.monitoring@logmein.com
edline.net	nil
payumoney.com	nil
hateblo.jp	nil
stockcharts.com	nil
afreeca.com	nil
loopnet.com	nil
funnyordie.com	nil
vikatan.com	nil
3bmeteo.com	nil
tokyo-porn-tube.com	nil
justhost.com	nil
2ememain.be	none	dmarcian
nic.ru	nil
entertainmentcrave.com	nil
streamable.com	nil
lrytas.lt	nil
rising.cn	nil
48ed4acf13b.se	nil
toyota.com	nil
geocities.co.jp	nil
hani.co.kr	nil
t-nation.com	nil
arduino.cc	nil
cic.fr	nil
convio.net	nil
yes.xxx	nil
kafan.cn	none	
jappy.de	nil
arxiv.org	nil
listverse.com	nil
auone.jp	nil
haber3.com	nil
mazika2day.com	nil
tsetmc.com	nil
giallozafferano.it	nil
searchina.net	nil
russia.tv	nil
lovoo.com	nil
adspoper.com	nil
a5cee7.se	nil
hltv.org	nil
designscrazed.org	nil
ocnk.net	nil
mr-johal.net	nil
carrefour.fr	nil
gayromeo.com	nil
check24.de	nil
mmo-champion.com	nil
iranestekhdam.ir	nil
tam.com.br	nil
99wed.com	nil
azcentral.com	invalid
greatist.com	nil
uci.edu	nil
rk.com	nil
videoweed.es	nil
desjardins.com	nil
banorte.com	quarantine	self,unknown:banorte_rua@dm.easysol.net,unknown:banorte_ruf@dm.easysol.net
lavasoft.com	nil
myworkday.com	nil
hc360.com	nil
ss.lv	nil
indiewire.com	nil
limetorrents.cc	nil
hotelscombined.com	nil
d1net.com	nil
reverbnation.com	quarantine	self
serialssolutions.com	nil
akakce.com	nil
24home.com	nil
britishcouncil.org	nil
lolnexus.com	nil
mangocity.com	nil
hertz.com	nil
quoka.de	nil
windowsazure.com	nil
tripadvisor.com.br	nil
debian.org	nil
etmall.com.tw	nil
linguee.es	nil
proflack.com	nil
enews.com.tw	nil
blueseek.com	nil
goadflack.com	nil
hir24.hu	nil
freshersworld.com	nil
synxis.com	nil
trivago.com	nil
do-search.com	nil
zamunda.net	nil
catracalivre.com.br	nil
daserste.de	nil
cima4u.tv	nil
almesryoon.com	nil
desk.com	none	agari
le360.ma	nil
sidereel.com	none	self
iol.co.za	nil
openrice.com	nil
jossandmain.com	nil
laptopmag.com	nil
newrelic.com	nil
ee.co.uk	nil
viamichelin.fr	nil
biography.com	nil
gongchang.cn	nil
nikkan-gendai.com	nil
voanews.com	nil
straitstimes.com	nil
animenewsnetwork.com	nil
els-cdn.com	nil
3movs.com	nil
antenam.info	nil
synology.com	nil
tnews.ir	reject	self
natemat.pl	invalid
interpals.net	nil
thestorypedia.com	nil
bluewin.ch	nil
mediotiempo.com	nil
pornbb.org	nil
cam4.de.com	nil
openoffice.org	nil
naturalnews.com	none	returnpath
gao7.com	nil
mawdoo3.com	nil
creditonebank.com	nil
signup.wordpress.com	nil
statista.com	nil
bvsrv.com	nil
tvb.com	nil
curbed.com	nil
tripadvisor.jp	nil
sportowefakty.pl	nil
prosperent.com	nil
uidai.gov.in	nil
pagesix.com	nil
mmotraffic.com	nil
hotmilfclips.com	nil
shoebuy.com	nil
softwaare.net	nil
sbup.com	nil
nerdist.com	nil
brother.com	nil
batepapo.uol.com.br	nil
gq.com	nil
cyworld.com	nil
tvp.pl	nil
kidstaff.com.ua	nil
tripadvisor.ru	nil
nex1music.com	nil
sporcle.com	nil
topit.me	nil
tophotels.ru	nil
tuniu.com	nil
angularjs.org	nil
rare.us	invalid
consultant.ru	nil
bunte.de	nil
emuparadise.me	nil
digitalpoint.com	nil
citizensbankonline.com	nil
businessdictionary.com	nil
topshop.com	nil
westelm.com	nil
lavozdegalicia.es	nil
blog.163.com	nil
publico.es	nil
livechatinc.com	nil
rai.tv	nil
pixshark.com	nil
logsoku.com	nil
moviepilot.de	nil
s2d6.com	nil
mobikwik.com	nil
news-postseven.com	nil
furaffinity.net	nil
car.gr	nil
totaljobs.com	nil
modelmayhem.com	nil
jschina.com.cn	nil
mturk.com	nil
mypearson.com	nil
bookdepository.com	nil
expatriates.com	nil
pcpartpicker.com	nil
mangastream.com	nil
dgtle.com	nil
skladchik.com	nil
dqx.jp	nil
runnersworld.com	nil
myheritage.com	nil
cdninstagram.com	nil
linode.com	nil
milb.com	nil
techsouth.org	nil
oceanofgames.com	nil
klmty.net	nil
minube.com	nil
memurlar.net	nil
desirulez.net	nil
yieldmedia.net	nil
lfmall.co.kr	nil
bisnis.com	nil
fssnet.co.in	nil
boohoo.com	nil
gonzoxxxmovies.com	nil
qiita.com	nil
cint.com	nil
ib-game.jp	nil
smartsheet.com	nil
patrika.com	nil
costco.ca	nil
virustotal.com	none	self:google
like4like.org	nil
g2g.fm	nil
natalie.mu	nil
tvspielfilm.de	nil
sammydress.com	nil
ngoisao.vn	nil
stream.cz	nil
antpedia.com	nil
raiffeisen.at	nil
vueling.com	nil
ntv.co.jp	nil
talkingpointsmemo.com	nil
sitesell.com	nil
santandernet.com.br	nil
comdotgame.com	nil
thisoldhouse.com	nil
naaptol.com	nil
adfa.co	nil
bseindia.com	nil
campograndenews.com.br	nil
yellowpages.ca	invalid
nickjr.com	nil
fao.org	nil
streamnowmovies.com	nil
nextmag.com.tw	nil
formula1.com	nil
carsales.com.au	nil
kalerkantho.com	nil
c-and-a.com	nil
lifescript.com		
defencenet.gr	nil
batdongsan.com.vn	nil
icy-veins.com	nil
banesco.com	nil
askmefast.com	nil
mixcloud.com	nil
telstra.com.au	nil
tpsl-india.in	nil
forbiddenplaygroundxxx.com	nil
adservingsolutionsinc.com	nil
cleveland.com	nil
csmonitor.com	nil
a9vg.com	nil
webgains.com	nil
comprendrechoisir.com	invalid
linkcrypt.ws	nil
binaryprofessional.com	nil
cumlouder.com	nil
nespresso.com	nil
iol.pt	nil
bigbasket.com	nil
netkeiba.com	nil
createspace.com	nil
ad126m.com	nil
zaycev.net	nil
tuttosport.com	nil
recode.net	invalid
niezalezna.pl	nil
recordchina.co.jp	nil
ox.ac.uk	nil
ardmediathek.de	nil
smosh.com	nil
adf.st	nil
google.hn	none	self:google
carfax.com	nil
yiwugou.com	nil
binarydistrict.net	nil
igma.tv	nil
onhax.net	nil
epson.com	nil
adfa.cc	nil
wowow.co.jp	nil
adsmarket.com	nil
roodo.com	nil
taisha.org	nil
adamoads.com	nil
f-picture.net	nil
endomondo.com	nil
golfdigest.co.jp	nil
razerzone.com	nil
bluedart.com	nil
ustraveldocs.com	nil
thepiratebay.to	nil
playzuu.com	nil
northwestern.edu	nil
filenuke.com	nil
penny-arcade.com	nil
mhlw.go.jp	nil
idbibank.co.in	nil
webdunia.com	nil
elsalvador.com	nil
qld.gov.au	nil
aukro.ua	nil
guff.com	nil
cheaa.com	nil
dominos.co.in	nil
jqueryui.com	nil
ddanzi.com	nil
befuck.com	nil
videosdemadurasx.com	nil
minijuegos.com	nil
internetspeedtracker.com	nil
000webhost.com	nil
paperlesspost.com	nil
binzhi.com	nil
bwin.com	nil
seemorgh.com	nil
cnki.com.cn	nil
epa.gov	nil
lesnumeriques.com	nil
rs-online.com	nil
bu.edu	nil
yoursearch.me	nil
muzofon.com	nil
damimage.com	nil
radikal.ru	nil
mci.ir	nil
fineco.it	nil
bibliocommons.com	nil
iha.com.tr	nil
alhea.com	nil
ktrmr.com	nil
pornerbros.com	nil
nationalreview.com	nil
text.ru	nil
netgear.com	nil
filmbagus21.com	nil
indianpornvideos.com	nil
cliphunter.com	nil
eurosport.com	nil
vitorrent.co	nil
lachainemeteo.com	nil
ishangman.com	nil
intercambiosvirtuales.org	nil
seamless.com	nil
hizliizlefilm.net	nil
youmaker.com	nil
zoomby.ru	nil
easydriverpro.com	nil
e-travel.com	nil
citruspay.com	nil
ogone.com		
phoenix.edu	nil
hjenglish.com	nil
forexpf.ru	nil
olx.com.ar	nil
mathsisfun.com	nil
periscope.tv	nil
wyborcza.biz	nil
2ch-2.net	nil
baby.ru	invalid
delfi.ee	nil
timesofindia.com	none	self
hsbc.com	none	agari
znds.com	nil
strawpoll.me	nil
pccomponentes.com	nil
alwakeelnews.com	nil
antena3.com	nil
mysearchdial.com	nil
xici.net	nil
portaleducacao.com.br	nil
tuoitre.vn	nil
techspot.com	nil
7netshopping.jp	nil
jetairways.com	nil
lefrecce.it	nil
xmovies8.co	nil
bakusai.com	nil
anime-sharing.com	nil
fasttech.com	nil
alef.ir	nil
xqzh2.com	nil
tamindir.com	nil
minutouno.com	nil
ad130m.com	nil
jamnews.ir	nil
upjers.com	nil
3djuegos.com	nil
nexon.com	nil
aglasem.com	nil
morningpost.com.cn	nil
laodong.com.vn	nil
koha.net	nil
cwb.gov.tw	nil
strato.de	nil
qinqinbaby.com	nil
themuse.com	nil
madamenoire.com	nil
4kmoviesclub.com	nil
standardchartered.co.in	nil
robokassa.ru	nil
addic7ed.com	nil
admin.ch	nil
maplestage.com	nil
bancosantander.es	nil
cmoney.tw	nil
thetrainline.com	nil
ninisite.com	nil
16888.com	nil
ibicn.com	nil
fuq.com	nil
uhaul.com	nil
fda.gov	nil
joshinweb.jp	nil
ladbrokes.com	nil
vavel.com	nil
osxdaily.com	nil
boyfriendtv.com	nil
pipedrive.com	nil
hyundaihmall.com	nil
c-sharpcorner.com	nil
buienradar.nl	nil
mywot.com	nil
macromedia.com	none	agari
citationmachine.net	nil
properfuck.com	nil
kodi.tv	nil
fb.com	none	agari
tv-asahi.co.jp	nil
dapenti.com	nil
fashionguide.com.tw	nil
solvusoft.com	nil
angelfire.com	nil
zoom.com.br	nil
newsbeast.gr	nil
tsn.ua	nil
band.us	nil
codeitive.com	nil
filesfetcher.com	nil
pia.jp	nil
safefinder.com	nil
hometalk.com	nil
mywapblog.com	invalid
seektoexplore.com	invalid
imgclick.net	nil
producthunt.com	nil
texas.gov	nil
gahe.com	nil
gottabemobile.com	nil
nascar.com	nil
amazon.com.br	quarantine	self:amazon
grindtv.com	invalid
singaporeair.com	nil
elkhabar.com	nil
meidebi.com	nil
buzzlie.com	nil
woobox.com	nil
fmworld.net	nil
coffetube.com	nil
0c9d8370d.se	nil
monova.org	nil
osu.edu	nil
inazumanews2.com	nil
mediaite.com	nil
thanhnien.com.vn	nil
coches.net	nil
eweb4.com	nil
standard.co.uk	nil
muscleandfitness.com	nil
sonhoo.com	nil
guitarcenter.com	nil
staseraintv.com	nil
tinkoff.ru	none	self
screwfix.com	nil
glamour.com	nil
digit.in	nil
aircanada.com	nil
msi.com	nil
barstoolsports.com	nil
elitetorrent.net	nil
7k7k.com	nil
showup.tv	nil
wechat.com	nil
speedanalysis.net	nil
hbo.com	nil
hayneedle.com	none	agari,self
theanimalrescuesite.com	nil
duke.edu	nil
rozee.pk	nil
filmix.net	nil
canon.jp	nil
geenstijl.nl	nil
proprofs.com	nil
imvu.com	nil
1000mg.jp	nil
commonhealth.com.tw	nil
kugou.com	nil
heftig.co	nil
championselect.net	nil
movshare.net	nil
groupon.de	none	self,agari
qinbei.com	nil
contentabc.com	nil
yaplog.jp	nil
dillards.com	nil
gomaji.com	none	
worldinformers.com	nil
couponraja.in	nil
ankieta-online.pl	nil
schoology.com	nil
expo2015.org	nil
reviewjournal.com	nil
very.co.uk	nil
homepage-web.com	nil
donedeal.ie	nil
banglamail24.com	nil
putlocker.ms	nil
viooz.ac	nil
savingstory.com	nil
pasionlibertadores.com	none	unknown:dmarc@planisys.com
nordea.fi	nil
iu.edu	nil
goud.ma	nil
netbk.co.jp	nil
yourepeat.com	nil
4club.com	nil
cimbclicks.com.my	nil
risaleajans.com	nil
techsmith.com	nil
beslist.nl	nil
verywed.com	nil
nova.cz	nil
honto.jp	nil
williams-sonoma.com	nil
dongtw.com	nil
1001fonts.com	nil
hitta.se	nil
baseball-reference.com	nil
ohmyzip.com	nil
98ia.com	nil
playground.ru	nil
medhelp.org	nil
rajnikantvscidjokes.in	nil
cam.ac.uk	nil
o2online.de	nil
83suncity.com	nil
silikonvadisi.tv	nil
cyberforum.ru	nil
mlit.go.jp	nil
lifehacker.jp	nil
d3.ru	nil
ourtime.com	none	returnpath
play.pl	nil
globalnews.ca	nil
abercrombie.com	nil
01ny.cn	nil
guildwars2.com	nil
gpoint.co.jp	nil
thesenlive.com	nil
dizibox.net	nil
securecode.com	nil
smithsonianmag.com	nil
kuaidi100.com	nil
sec.gov	nil
mosaiquefm.net	nil
dilbert.com	nil
114so.cn	nil
tiantian.com	nil
strikingly.com	nil
lifehacker.ru	nil
tamilrockers.com	nil
webmotors.com.br	nil
ncsu.edu	nil
ems.com.cn	nil
spirit.com	nil
dreamhost.com	nil
funweek.it	none	
space.com	nil
qiwi.ru	nil
yuku.com	nil
clickfunnels.com	nil
weddingwire.com	nil
cocacola.co.jp	nil
mp4ba.com	nil
bezuzyteczna.pl	nil
service-now.com	nil
vodafone.de	nil
zigwheels.com	nil
ihotelier.com	nil
xataka.com	nil
elephantjournal.com	nil
avxsearch.se	nil
quepasada.cc	nil
npmjs.com	nil
trendyol.com	nil
jkanime.net	nil
china.cn	nil
bigstockphoto.com	nil
slashfilm.com	nil
alibaba-inc.com	none	self:alibaba
dinakaran.com	nil
battlenet.com.cn	nil
medi1tv.com	nil
sjtu.edu.cn	nil
orange.pl	nil
sub.jp	nil
ciudad.com.ar	quarantine	dmarcian,self
cameraprive.com	nil
unroll.me	invalid
contra.gr	nil
fifa.com	nil
18374ir.com	nil
wanfangdata.com.cn	nil
techbargains.com	nil
grooveshark.com	invalid
prwidgets.com	nil
google.com.om	none	self:google
gunbroker.com	nil
promoinsights.net	nil
almanar.com.lb	nil
listenonrepeat.com	nil
sbs.com.au	nil
finviz.com	nil
mouser.com	nil
icontact.com	nil
bonanza.com	nil
ubs.com	nil
leonardo.it	nil
hi-pda.com	nil
prostoporno.net	nil
harvestapp.com	invalid
apply2jobs.com	none	agari
farpost.ru	nil
psychcentral.com	nil
przegladsportowy.pl	invalid
canadapost.ca	nil
proceso.com.mx	nil
pururin.com	nil
virgula.uol.com.br	nil
libertatea.ro	nil
meizu.com	nil
chewen.com	nil
top1health.com	nil
grainger.com	nil
rte.ie	none	self
capterra.com	nil
sifyitest.com	nil
uline.com	none	agari
ilikeyouhorny.com	nil
theaustralian.com.au	nil
gamebase.com.tw	nil
celebritynetworth.com	invalid
overclock.net	nil
egloos.com	nil
litmir.info	nil
cokeandpopcorn.ch	nil
extremetech.com	nil
bato.to	nil
wanelo.com	none	messagebus
incredibar-search.com	nil
yunfile.com	nil
katespade.com	reject	agari
macworld.co.uk	nil
uncrate.com	nil
androidforums.com	nil
vg247.com	nil
inosmi.ru	nil
fansshare.com	nil
techtimes.com	nil
airdroid.com	nil
jamejamonline.ir	nil
rechargeitnow.com	nil
arte.tv	nil
moviefone.com	nil
siamsport.co.th	nil
googlecode.com	none	self:google
vipgouyouhui.com	nil
retenews24.it	nil
enjin.com	nil
raspberrypi.org	nil
express.com	nil
met-art.com	nil
aeat.es	nil
xtool.ru	nil
linkprice.com	nil
creativecommons.org	nil
nextdirect.com	nil
zoomit.ir	nil
rssing.com	nil
winshang.com	nil
mlsmatrix.com	nil
hangseng.com	none	agari
olymptrade.com	quarantine	self
nicoseiga.jp	nil
mandatory.com	nil
parkoz.com	nil
boldsky.com	nil
nationalpost.com	nil
nabble.com	nil
wordhippo.com	nil
segodnya.ua	none	self
ets.org	nil
babyschool.com.cn	nil
okmagazine.com	nil
55haitao.com	nil
ebags.com	none	returnpath
desinema.com	nil
kaiwind.com	nil
dish.com	nil
planet49.com	none	self
elperiodico.com	nil
alaham.org	nil
barclaycard.co.uk	nil
shindanmaker.com	nil
comicbookmovie.com	nil
clubpenguin.com	nil
scamadviser.com	nil
paultan.org	nil
saraba1st.com	nil
kuwo.cn	nil
newsner.com	nil
etxt.ru	nil
filefactory.com	nil
pordede.com	nil
hbonow.com	nil
sarzamindownload.com	nil
tsu.co	nil
mythemeshop.com	nil
huffingtonpost.gr	nil
younow.com	nil
post-survey.com	nil
prosieben.de	nil
wenkang.cn	nil
wrapbootstrap.com	nil
arvixe.com	nil
sportsauthority.com	nil
javedch.com	nil
yenibiris.com	nil
hugefiles.net	nil
gigya.com	none	self
kanasoku.info	nil
ladepeche.fr	nil
latercera.com	nil
hipchat.com	invalid
moddb.com	nil
choxi.com	nil
surrenderat20.net	nil
virgin-atlantic.com	nil
decathlon.fr	nil
sur.ly	nil
gothamist.com	nil
vipsister23.com	nil
tvtoday.de	nil
builtwith.com	none	self
everychina.com	nil
reliancebroadband.co.in	nil
zhidao.baidu.com/user/admin	nil
docusign.com	none	agari
minhateca.com.br	nil
i-gamer.net	nil
unfollowers.com	nil
dhnet.be	invalid
webgozar.com	nil
punishtube.com	invalid
vecernji.hr	nil
aranzulla.it	invalid
computrabajo.com.mx	nil
aramex.com	nil
netpnb.com	nil
peru.com	nil
elog-ch.com	nil
triviatoday.com	nil
novamov.com	nil
thingiverse.com	nil
etoro.com	nil
imgdino.com	nil
sparda.de	nil
efukt.com	nil
worldmarket.com	nil
collider.com	nil
bankbazaar.com	nil
mnrate.com	nil
fakku.net	nil
jp.net	invalid
virtualtourist.com	nil
jojobaa.net	nil
4travel.jp	invalid
idlebrain.com	nil
uscourts.gov	none	self
wikitravel.org	nil
amctheatres.com	nil
livenation.com	nil
mutedownload.com	nil
neu6.edu.cn	nil
stuccu.com	nil
juno.com	nil
huffingtonpost.es	nil
leadzu.com	nil
shinhancard.com	nil
treccani.it	nil
ancestry.co.uk	none	returnpath
givemesport.com	nil
dardarkom.com	nil
dunyanews.tv	nil
rj.gov.br	nil
sciencemag.org	nil
rtbf.be	nil
studiopress.com	nil
billiger.de	nil
notebooksbilliger.de	nil
nalog.ru	nil
enstage.com	nil
nicozon.net	nil
forumhouse.ru	nil
bettycrocker.com	nil
thaivisa.com	nil
egovtjobs.in	nil
aeriagames.com	nil
ssc.nic.in	nil
levi.com	nil
giveawayoftheday.com	nil
pornoid.com	nil
glwiz.com	nil
dir.bg	nil
tureng.com	nil
fashionara.com	nil
admitad.com	nil
aetna.com	reject	agari
buffalo.jp	nil
newsbomb.gr	nil
ghatreh.com	nil
vippers.jp	nil
titanfilerse.com	nil
tradera.com	nil
mundo.com	nil
twwtn.com	nil
jumei.com	nil
arizona.edu	nil
webtransfer-finance.com	nil
phununet.com	nil
eprice.com.tw	nil
icq.com	nil
heraldsun.com.au	nil
firstcry.com	nil
businesswire.com	nil
bbspink.com	nil
dailyfinance.com	nil
symplicity.com	nil
foreseegame.com	nil
novayagazeta.ru	nil
disp.cc	nil
slutload.com	invalid
kissmanga.com	nil
shadbase.com	nil
rolandgarros.com	nil
alarabeyes.com	nil
shopyourway.com	nil
lurkmore.to	nil
vid2c.com	nil
intodns.com	nil
warez-bb.org	nil
stylecraze.com	nil
qqbaobao.com	nil
oldnavy.com	none	agari,returnpath
apsense.com	nil
shoptime.com.br	nil
kolalwatn.net	nil
gaiaonline.com	nil
yunpan.cn	nil
markt.de	nil
stream2watch.com	nil
webrazzi.com	nil
xhamster.com/user/video	nil
animeshow.tv	nil
kdslife.com	nil
songkick.com	nil
nieuwsblad.be	nil
vov.vn	nil
freeimages.com	nil
symbaloo.com	nil
dealsea.com	nil
upsssc.gov.in	nil
ca168.com	nil
1800flowers.com	none	self
ratewrite.tmall.com	nil
hypebeast.com	nil
tenpay.com	nil
djmaza.info	nil
powershow.com	nil
utah.edu	nil
sportingvideo.tv	nil
gingersoftware.com	nil
linuxquestions.org	nil
cosme.net	nil
stirileprotv.ro	nil
adreactor.com	nil
france24.com	nil
dji.com	nil
jahannews.com	nil
ladduz.com	nil
kindgirls.com	nil
animenova.tv	nil
enjoydressup.com	nil
womai.com	nil
naszemiasto.pl	nil
unfranchise.com.tw	nil
labaq.com	nil
good.is	nil
erail.in	invalid
sketchup.com	nil
groupon.fr	none	self,agari
hollisterco.com	nil
iberia.com	nil
mycokerewards.com	nil
virginia.edu	nil
hobbylobby.com	nil
rtl.fr	nil
alrajhibank.com.sa	nil
hebei.com.cn	nil
dba.dk	none	dmarcian
elektroda.pl	nil
sweetwater.com	none	self
entertainment-factory.com	nil
redbull.com	nil
hot-sex-tube.com	nil
hackforums.net	nil
hotnews.ro	nil
support.wordpress.com	nil
mihanwebads.com	nil
ab-in-den-urlaub.de	nil
7fg2.com	nil
jhu.edu	nil
autorambler.ru	nil
hawamer.com	nil
gutenberg.org	nil
twojapogoda.pl	nil
pcbeta.com	nil
360safe.com	nil
casa.it	none	self
cvent.com	none	self
rp-online.de	nil
newslinq.com	nil
queerty.com	nil
retrogamer.com	nil
budsgunshop.com	nil
fastcodesign.com	nil
spotlight-media.jp	nil
avaaz.org	none	self,dmarcian
childrensplace.com	nil
d1ev.com	nil
siasat.pk	nil
veoh.com	nil
backlinkwatch.com	nil
datafile.com	nil
afip.gob.ar	nil
cybersource.com	quarantine	returnpath
admob.com	none	self:google
tadawul.com.sa	nil
chevrolet.com	nil
1001freefonts.com	nil
clickindia.com	nil
qantas.com.au	none	returnpath
sekindo.com	nil
sparkasse.at	nil
bancomer.com	nil
gamestorrents.com	nil
kekkon-sokuho.com	nil
ycwb.com	nil
bdjobs.com	nil
largeporntube.com	nil
cartrade.com	nil
bbvanet.com.mx	nil
eventim.de	nil
deser.pl	nil
athome.co.jp	nil
cookinglight.com	nil
somethingawful.com	nil
orientaltrading.com	nil
letsebuy.com	nil
food52.com	nil
notebookcheck.net	nil
westernunion.com	reject	agari
gandul.info	nil
cari.com.my	nil
tripadvisor.com.au	nil
gaytube.com	nil
wolfram.com	nil
egokick.com	nil
airtelforum.com	nil
papy.co.jp	nil
sexgangsters.com	nil
movistarpromociones.mx	nil
huntington.com	reject	dmarcian,self
benesse.ne.jp	nil
ed2000.com	nil
photoshelter.com	nil
grepolis.com	nil
soufun.com	nil
avvo.com	nil
gem.pl	nil
immi.gov.au	nil
nanapi.jp	nil
hs.fi	nil
huffingtonpost.de	nil
traveloka.com	nil
stltoday.com	nil
hvg.hu	nil
pizap.com	nil
vidzi.tv	nil
roku.com	nil
portaldasfinancas.gov.pt	nil
blogcu.com	nil
fashion-method.com	none	self
finevids.xxx	nil
artron.net	nil
sainsburys.co.uk	nil
bollywoodlife.com	nil
dospara.co.jp	nil
imgflip.com	nil
response.jp	nil
rt.ru	nil
mygully.com	nil
ucoz.ua	nil
kathimerini.gr	nil
brigitte.de	nil
wdc.com	nil
financial-net.com	nil
cs.com.cn	nil
mathxl.com	nil
imgzap.com	nil
woxikon.de	nil
longurl.it	nil
mcchina.com	nil
casino.com	nil
123kubo.com	nil
americanswan.com	nil
p-bandai.jp	nil
paixie.net	nil
mca.gov.in	nil
adobeconnect.com	nil
re-markable.net	nil
cinematoday.jp	nil
9news.com.au	nil
getintopc.com	nil
atmarkit.co.jp	nil
ilivid.com	nil
libertagia.com	nil
vzw.com	nil
bonappetit.com	nil
lavozdelmuro.net	nil
hdblog.it	nil
jpn.org	nil
google.com.cy	reject	self:google
176.com	nil
safelinkreview.com	nil
deloitte.com	nil
net.hr	nil
jeunesseglobal.com	nil
cloudify.cc	nil
animeid.tv	nil
quickmeme.com	nil
researchnow.com	nil
dobreprogramy.pl	nil
bikroy.com	nil
realself.com	nil
2670.com	nil
enotes.com	nil
ponpare.jp	nil
mytrafficvalue.com	nil
dev-point.com	nil
pluralsight.com	nil
academic.ru	nil
carid.com	none	dmarcian
aliorbank.pl	nil
myscore.ru	nil
redakcja.pl	nil
mercurynews.com	nil
prpops.com	nil
bb-dating.com	nil
thumbzilla.com	nil
youxiduo.com	nil
anyporn.com	nil
bestsoftwarelive.com	nil
govdelivery.com	nil
dopr.net	nil
xyz123.cn	nil
dailytelegraph.com.au	nil
gosuslugi.ru	nil
bell.ca	none	unknown:dmarkbell@bellnexxia.net
millionaireclub.co	nil
dfiles.ru	nil
subdivx.com	nil
gistreel.com	nil
deichmann.com	nil
bakeca.it	nil
tharunaya.co.uk	nil
ti.com	nil
spi0n.com	nil
crutchfield.com	none	self
tdameritrade.com	nil
seagate.com	nil
clicky.com	nil
nazwa.pl	nil
p-world.co.jp	nil
chakrads.com	nil
postimees.ee	nil
tech-wd.com	nil
intouchweekly.com	nil
livrariasaraiva.com.br	nil
vietcombank.com.vn	nil
enfemenino.com	nil
goldenline.pl	nil
bankcomm.com	nil
tkec.com.tw	nil
pec.it	nil
bundlestars.com	nil
mtvindia.com	nil
sexu.com	nil
torrentday.com	nil
incometaxindiaefiling.gov.in	none	unknown:mailreports_efiling@incometax.gov.in
digikey.com	invalid
thecrux.com	nil
despegar.com.ar	nil
monex.co.jp	nil
hsoub.com	nil
bundesliga.de	nil
aftabir.com	nil
brazzersnetwork.com	nil
hujiang.com	nil
17zwd.com	nil
sblo.jp	nil
massdrop.com	nil
indiabix.com	nil
gnu.org	nil
pdfonline.com	nil
celebridades.uol.com.br	nil
afrizap.com	nil
biztok.pl	nil
baixing.com	nil
toprightnews.com	nil
goindigo.in	nil
ucsb.edu	nil
e24.no	nil
kapaza.be	nil
lajmi.net	nil
bellanaija.com	nil
media1first.com	nil
downloadastro.com	nil
garaanews.com	nil
fox.com	nil
svd.se	nil
empowernetwork.com	nil
tcs.com	nil
ratp.fr	nil
voegol.com.br	none	agari
webtekno.com	nil
mandrillapp.com	nil
huxiu.com	nil
rudaw.net	nil
netease.com	nil
no-ip.com	none	self
yad2.co.il	nil
census.gov	nil
pulse.ng	nil
baiduyun.me	nil
lilplay.com	nil
rockpapershotgun.com	nil
easports.com	nil
bangkokbank.com	nil
utoronto.ca	nil
zeetv.com	nil
firefoxchina.cn	nil
enjoygram.com	nil
instaforex.com	nil
property24.com	nil
carnival.com	nil
huffingtonpost.kr	nil
kshowonline.com	nil
864321.com	invalid
extrabux.com	invalid
onlinekhabar.com	nil
balkanweb.com	nil
teamliquid.net	nil
tanoshikoto.com	nil
mymovies.it	nil
chinabroadcast.cn	nil
hsbc.com.mx	none	agari
hoovers.com	reject	agari
backpackers.com.tw	nil
radiko.jp	nil
mediatemple.net	nil
twirpx.com	nil
beinsports.net	nil
criminalcasegame.com	nil
guns.ru	nil
iranjib.ir	nil
autobild.de	nil
sastasundar.com	nil
soompi.com	nil
zurb.com	nil
hotnewhiphop.com	nil
vezunchik.club	nil
renfe.com	nil
emao.com	nil
diynetwork.com	nil
ozy.com	nil
pornyeah.com	nil
state.nj.us	nil
trendin.com	nil
mercusuar.info	nil
n72adserv.com	nil
indiocasino.com	nil
shiksha.com	none	unknown:emailadmin@infoedge.com!10m
theweek.com	nil
hightail.com	nil
wlp-acs.com	nil
nolo.com	nil
self.com	nil
mediamarkt.es	nil
runtastic.com	nil
alarab.net	invalid
citehr.com	nil
myroyalewin.com	nil
crucial.com	nil
alitrip.com	nil
timeslive.co.za	nil
citrix.com	nil
cian.ru	nil
jtb.co.jp	nil
hottopic.com	nil
imlive.com	nil
williamhill.es	nil
iprima.cz	nil
newpost.gr	nil
pulscen.ru	nil
cnnamador.com	nil
basspro.com	nil
giaoducthoidai.vn	nil
pcwelt.de	nil
miyabaobei.com	nil
namu.wiki	nil
yelp.ca	none	self
anetwork.ir	nil
avangate.com	nil
virginia.gov	nil
cnnindonesia.com	nil
git-scm.com	nil
parse.com	nil
etihad.com	nil
toukoucity.to	nil
macmillandictionary.com	nil
charter97.org	nil
theme-fusion.com	nil
totalbeauty.com	nil
probiller.com	nil
dreammail.jp	nil
pracuj.pl	nil
amiami.jp	nil
htcmania.com	invalid
cifraclub.com.br	nil
tuicool.com	nil
wankr.com.cn	nil
google.tt	none	self:google
neowin.net	nil
cheaptickets.com	nil
37signals.com	none	unknown:rua@basecamp.com,unknown:ruf@basecamp.com
linkis.com	nil
takepart.com	nil
marieclaire.com	nil
ideel.com	nil
artww.com	nil
storenvy.com	nil
ultrafarma.com.br	nil
homebase.co.uk	nil
nettavisen.no	nil
paheal.net	nil
socialsurveysgroup.com	nil
designmantic.com	nil
krone.at	nil
clkmon.com	nil
lovetoknow.com	nil
tinhte.vn	nil
se.pl	nil
spicejet.com	nil
gungho.jp	nil
nk.pl	nil
filmstarts.de	nil
webpagetest.org	nil
archive.is	nil
cplusplus.com	nil
authorstream.com	nil
surveee.org	nil
thewrap.com	nil
realitatea.net	none	dmarcian
helpscout.net	nil
vt.edu	none	dmarcian
expedia.co.uk	reject	returnpath
socialsecurity.gov	nil
caloriecount.com	nil
souqiantu.com	none	self:netease
rajanews.com	nil
sggc.com.cn	nil
chsi.com.cn	nil
flipkey.com	invalid
fonearena.com	nil
qatarliving.com	nil
bandsintown.com	invalid
hqtube.xxx	nil
pasion.com	nil
putlocker.tn	nil
thiruttuvcd.me	nil
1sale.com	nil
piliapp.com	nil
advanceautoparts.com	nil
buxvertise.com	nil
sportingnews.com	nil
prokerala.com	none	postmarkapp
warpex.com	nil
rakuten.jp	nil
webmasterplan.com	nil
balagannna.com	nil
beyond.com	nil
enikos.gr	nil
jamieoliver.com	nil
india-forums.com	nil
deutschepost.de	reject	agari
manutd.com	nil
pekao24.pl	nil
eset.com	nil
divxtotal.com	nil
lingualeo.com	none	unknown:dmarc@expertsender.ru
buenosearch.com	nil
limeroad.com	nil
toyota.jp	nil
mogujie.com	none	self:netease
iis.net	nil
findwide.com	nil
fastspring.com	nil
sii.cl	nil
komando.com	nil
svoboda.org	nil
gasengi.com	nil
alfavita.gr	nil
natro.com	none	unknown:dmarc.result@iletis.com
kerala.gov.in	nil
oprah.com	nil
douban.fm	nil
macrojuegos.com	nil
noticiaaldia.com	nil
exam8.com	nil
colorado.edu	nil
army.mil	nil
freepeople.com	nil
ow.ly	nil
loteriasyapuestas.es	nil
umeng.com	nil
urssaf.fr	nil
tori.fi	nil
hclips.com	nil
10fbb07a4b0.se	nil
leguide.com	nil
ard.de	nil
launchpad.net	nil
parenting.com.tw	nil
mafiashare.net	nil
vudu.com	nil
babble.com	nil
mop.com	nil
800hr.com	nil
juicyads.com	nil
newser.cc	nil
zynga.com	none	
pingan.com	nil
whmcs.com	nil
buyhatke.com	nil
odometer.com	nil
searchnu.com	nil
kindle114.com	nil
rusnovosti.ru	nil
mediaworld.it	nil
berlin.de	nil
almorakib.com	nil
dramasonline.com	nil
searchult.com	nil
51weibo.com	nil
appleinsider.com	nil
websitedhoome.com	nil
sbazar.cz	invalid
meduza.io	nil
catho.com.br	none	self
linktech.cn	nil
desitvforum.net	nil
24ur.com	nil
google.am	reject	self:google
turkcell.com.tr	nil
gmx.com	nil
choicehotels.com	nil
avon.com	none	agari
2nn.jp	nil
jqueryscript.net	nil
freebitco.in	nil
toggl.com	nil
coub.com	nil
waveapps.com	none	dmarcanalyzer
hellomagazine.com	nil
webopedia.com	nil
tsb.co.uk	reject	agari
aawsat.com	nil
oreilly.com	nil
shlandscape.com	nil
secretsdujeu.com	nil
whowhatwear.com	nil
vevo.com	nil
technobuffalo.com	nil
namnak.com	nil
rassd.com	nil
head-fi.org	nil
dom2.ru	nil
onetravel.com	nil
semana.com	nil
rfi.fr	nil
viglink.com	nil
jqueryrain.com	nil
srf.ch	nil
midwayusa.com	nil
epfoservices.in	nil
voici.fr	nil
adyen.com	nil
buyee.jp	nil
seosprint.net	nil
straightdope.com	nil
discas.net	nil
hornbach.de	nil
sanguosha.com	nil
010com.cn	nil
centos.org	nil
openstreetmap.org	nil
aemet.es	nil
itimes.com	nil
snn.ir	nil
roboform.com	nil
onecall2ch.com	nil
foodpanda.in	nil
publico.pt	nil
gsp.ro	nil
quizly.io	nil
usp.br	nil
reverb.com	nil
ranksignals.com	nil
121ware.com	nil
level3.com	nil
arageek.com	nil
acads.net	nil
nahuo.com	nil
pervclips.com	nil
hmrc.gov.uk	none	unknown:Dmarc.Aggregate@hmrc.gsi.gov.uk,returnpath,unknown:Dmarc.Forensic@hmrc.gsi.gov.uk
behindwoods.com	nil
just-eat.co.uk	nil
popsci.com	nil
dinodirect.com	nil
dena-ec.com	nil
cardinalcommerce.com	nil
hrloo.com	nil
torrenty.org	nil
findlaw.com	nil
playit.pk	nil
jumia.ci	nil
fc2web.com	nil
news-choice.net	nil
vagas.com.br	nil
unian.net	nil
tokyo-sports.co.jp	nil
eatingwell.com	nil
soup.io	nil
playsport.cc	nil
ismedia.jp	nil
grid.mk	nil
gfxtra2.net	nil
fussball.de	nil
clips4sale.com	invalid
a2g-secure.com	nil
kanald.com.tr	nil
lexilogos.com	nil
tuttomercatoweb.com	nil
palcomp3.com	nil
myflorida.com	nil
schoolloop.com	nil
europapress.es	nil
mitele.es	nil
verseriesynovelas.com	nil
madmimi.com	reject	self
hilltopads.net	nil
afisha.ru	nil
liontravel.com	nil
dvdvideosoft.com	nil
underarmour.com	nil
weloveshopping.com	nil
efu.com.cn	nil
typeform.com	nil
payserve.com	nil
ebay.be	none	agari,returnpath
centerblog.net	nil
motortrend.com	nil
linio.com.pe	nil
mtwebcenters.com.tw	nil
weather.gc.ca	nil
peru21.pe	nil
newindianexpress.com	nil
thomson.co.uk	nil
rahnama.com	nil
emedicinehealth.com	nil
rubias19.com	nil
markafoni.com	reject	
minhavida.com.br	nil
pingomatic.com	nil
share-online.biz	nil
seositecheckup.com	nil
promptfile.com	nil
dajie.com	nil
crumb.com	nil
homeadvisor.com	nil
youx.xxx	nil
dota2lounge.com	nil
ulozto.cz	invalid
persiantools.com	none	self
obi.de	nil
houseoffraser.co.uk	nil
gencat.cat	nil
hawaaworld.com	nil
publix.com	nil
ofigenno.cc	nil
cliponyu.com	nil
mcssl.com	nil
021lh.net	nil
nii.ac.jp	nil
goldesel.to	nil
dailyfx.com	nil
ar15.com	nil
brucelead.com	nil
trafficholder.com	nil
metoffice.gov.uk	nil
photofans.cn	nil
sirsi.net	nil
u17.com	nil
xfig.net	nil
ig.com	none	returnpath
olx.uz	nil
pcfinancial.ca	nil
kissmetrics.com	nil
exacttarget.com	none	returnpath,agari
google.com.lb	none	self:google
livesports.pl	nil
jomashop.com	nil
wetalk.tw	nil
iwank.tv	nil
hip2save.com	invalid
classifiedads.com	invalid
softcoin.com	nil
toroporno.com	nil
buyma.com	nil
mob.org	nil
51credit.com	nil
webnode.com	nil
channelnewsasia.com	nil
dollarphotoclub.com	nil
fodors.com	nil
asiaone.com	nil
openclassrooms.com	nil
kompass.com	nil
kidshealth.org	nil
scarymommy.com	nil
slickamericans.com	nil
competitor.com	nil
aeon.co.jp	nil
2checkout.com	nil
macupdate.com	nil
vidspot.net	nil
447.xyz	nil
265.com	none	self:google
microcenter.com	nil
expedia.ca	reject	returnpath
fotolog.com	nil
dslreports.com	nil
truecar.com	nil
powerschool.com	nil
futura-sciences.com	nil
colorlib.com	nil
liverpoolfc.com	nil
piratestreaming.co	nil
dailythanthi.com	nil
123telugu.com	nil
sportmaster.ru	nil
priyo.com	nil
onlinemovies.pro	nil
stafaband.info	nil
aib.ie	nil
techpowerup.com	nil
orange.es	nil
sciencealert.com	nil
myadvertisingpays.com	nil
7sur7.be	nil
ad135m.com	nil
pep.ph	nil
svpressa.ru	nil
liberoquotidiano.it	nil
soccermanager.com	nil
freemake.com	nil
ilvyou.cc	nil
ad136m.com	nil
phys.org	nil
hao123.com.eg	nil
qpolitical.com	nil
n24.de	nil
seo-fast.ru	nil
gaadi.com	nil
santanderrio.com.ar	nil
falabella.com	nil
washwasha.org	nil
alkhaleejaffairs.org	nil
torrents.net	nil
occ.com.mx	nil
theoatmeal.com	nil
afl.com.au	nil
nts.org.pk	nil
infojobs.it	nil
indiaglitz.com	nil
baykoreans.net	nil
xpg.uol.com.br	nil
cnw.com.cn	nil
tudogostoso.com.br	nil
myfxbook.com	nil
dnevnik.hr	nil
hizlial.com	nil
jollychic.com	nil
java2s.com	nil
techweb.com.cn	nil
bookingbuddy.com	nil
opodo.co.uk	nil
icolor.com.cn	nil
stylebistro.com	nil
coolkora.com	nil
molotok.ru	nil
idbi.com	nil
demotivateur.fr	nil
tradekorea.com	nil
planet.fr	nil
seoprofiler.com	nil
libertyland.tv	nil
flypgs.com	nil
kia.com	nil
auchan.fr	nil
w3snoop.com	nil
gboxapp.com	nil
manchestereveningnews.co.uk	nil
consequenceofsound.net	invalid
clkengine.com	nil
eventful.com	none	self
wistia.com	nil
spielaffe.de	nil
el7l.co	nil
wordssl.net	nil
moneysupermarket.com	reject	returnpath
pichost.me	nil
torrentreactor.com	nil
keywordtool.io	none	
boxza.com	nil
glosbe.com	nil
sportsguru.in	nil
1jux.net	nil
mojang.com	invalid
hirezstudios.com	nil
peliculasflv.co	nil
pornvideoxo.com	nil
newsvine.com	nil
exlibrisgroup.com	nil
recruitmentresult.com	nil
meteomedia.com	nil
aeroflot.ru	nil
guiaconsumidor.com	nil
zalora.co.id	nil
neopets.com	nil
sogi.com.tw	nil
rabota.ru	reject	self,unknown:rabota_ru_postmaster@mail.ru
yjbys.com	nil
loxblog.com	nil
loveplanet.ru	nil
tgfcer.com	nil
quidco.com	nil
ringcentral.com	none	agari,self
affili.net	nil
999120.net	nil
xendan.org	nil
u-car.com.tw	nil
adafruit.com	nil
sigmalive.com	nil
porsche.com	nil
cyclingnews.com	nil
netvasco.com.br	nil
steamgifts.com	nil
spox.com	nil
haberself.com	invalid
imp.free.fr	nil
hotpads.com	nil
search.ch	nil
housefun.com.tw	nil
alpari.ru	none	unknown:dmarc-report@alpari.org
archlinux.org	nil
canstockphoto.com	nil
alexaboostup.com	nil
wplocker.com	nil
cooltext.com	nil
onlinemultfilmy.ru	nil
scroll.in	nil
elong.com	nil
cam4.it	nil
srclickpro.ru	nil
theadvocate.com	nil
cn163.net	nil
shared.sx	nil
vosteran.com	nil
ultimasnoticias.com.ve	nil
cruisecritic.com	nil
stargames.at	nil
supersport.com	nil
yabaleftonline.com	nil
southernliving.com	nil
gry-online.pl	nil
gymboree.com	none	agari
cyberlink.com	nil
timesofmalta.com	nil
filmsenzalimiti.co	nil
economicos.cl	nil
hklmm.com	nil
jpost.com	nil
wrike.com	nil
xrea.com	nil
collegeconfidential.com	nil
liga.net	nil
business2community.com	nil
familyhandyman.com	nil
ligatus.com	nil
tgju.org	nil
gulfnews.com	nil
yxdown.com	nil
silvergames.com	nil
12place.com	nil
streeteasy.com	nil
fishwrapper.com	nil
locaweb.com.br	none	self
guiamais.com.br	nil
girlsplay.com	nil
opahnet.com	nil
biglots.com	nil
bankier.pl	nil
feiren.com	nil
giveaways.club	nil
experienceproject.com	nil
gratka.pl	nil
which.co.uk	nil
derwesten.de	nil
navegaki.com	nil
unbounce.com	nil
classiccars.com	nil
piktochart.com	none	postmarkapp
hostmonster.com	nil
skidrowreloaded.com	nil
seattlepi.com	nil
fixxr.info	nil
doityourself.com	nil
ch.com	nil
poppen.de	invalid
seancody.com	nil
pastemagazine.com	nil
xs8.cn	nil
colatour.com.tw	nil
shlac.com	nil
playcast.ru	nil
tv-tokyo.co.jp	nil
hochi.co.jp	nil
blizzard.com	none	returnpath
rlsbb.com	nil
sabaharabi.com	nil
bibsonomy.org	nil
webdesignerdepot.com	nil
mtv.fi	nil
fancy.com	nil
rogers.com	nil
2tu.cc	nil
mnn.com	nil
yourbittorrent.com	invalid
express.de	nil
asos.fr	nil
imooc.com	nil
findamo.com	nil
sep.gob.mx	nil
bozhong.com	nil
lottedfs.com	nil
seoul.co.kr	nil
casadellibro.com	nil
upi.com	nil
alsbbora.com	nil
horoscope.com	none	unknown:dmarc-feedback@center.com,unknown:dmarc-forensic@center.com
adblockplus.org	nil
halifax.co.uk	reject	agari
intercom.io	none	self
haidaibao.com	nil
sharebuilder.com	none	agari
teknosa.com	nil
linguee.com	nil
pistonheads.com	nil
telmex.com	nil
aristeguinoticias.com	nil
pardad.ir	nil
juegosjuegos.com	nil
magento.com	nil
fextralife.com	nil
g9g.com	nil
eztv.it	nil
lgmi.com	nil
myfirstclasslife.com	nil
live-smi.ru	nil
piaohua.com	nil
formstack.com	none	dmarcian,self
fitnessmagazine.com	nil
etsystatic.com	nil
orico.co.jp	nil
shape.com	nil
mg.gov.br	nil
stoloto.ru	none	self
coinmill.com	nil
google.co.cr	reject	self:google
audiojungle.net	nil
xxxkinky.com	nil
kbs.co.kr	nil
lipsum.com	nil
fonts.com	nil
onvasortir.com	nil
digital-photography-school.com	nil
anonymz.com	nil
empornium.me	nil
juooo.com	nil
51seer.com	nil
mol.gov.sa	nil
zbiornik.com	invalid
kar.nic.in	nil
skelbiu.lt	nil
fingerhut.com	nil
wind.it	nil
weeronline.nl	nil
ut.ac.ir	nil
winzip.com	nil
avis.com	nil
movie25.ag	nil
whatismyip.com	nil
yeucahat.com	nil
mbalib.com	nil
dizipub.com	nil
gatech.edu	nil
googleping.com	nil
ekantipur.com	nil
mzamin.com	nil
indiatvnews.com	nil
totaljerkface.com	nil
hillnews.com	nil
ttnet.com.tr	nil
gytabukirew.com	nil
huffpost.com	nil
tv2.dk	nil
marketo.com	none	agari
coocan.jp	nil
askul.co.jp	nil
gongkong.com	nil
ubc.ca	nil
seoclerks.com	nil
gosugamers.net	nil
zapkolik.com	nil
ndr.de	nil
thedodo.com	nil
boards.ie	nil
joesnewbalanceoutlet.com	nil
sina.com	nil
cultofmac.com	nil
startlap.hu	nil
joyreactor.cc	nil
tonicmovies.com	nil
lyricsfreak.com	nil
somoyerkonthosor.com	nil
mamibuy.com.tw	nil
scrubtheweb.com	nil
mywebface.com	nil
tirerack.com	nil
themarysue.com	nil
stocktwits.com	nil
engageya.com	nil
echosign.com	quarantine	returnpath
rlslog.net	nil
cuisineaz.com	nil
sdpnoticias.com	nil
epost.go.kr	nil
airliners.net	nil
jacquielawson.com	reject	unknown:fbl@americangreetings.com,agari
michigan.gov	nil
kepizufycam.com	nil
disneylatino.com	nil
cadenaser.com	nil
largepornfilms.com	nil
mercadolibre.com.pe	nil
google.mg	none	self:google
scielo.br	nil
digitalplayground.com	nil
airberlin.com	nil
kitco.com	nil
whitehouse.gov	nil
br.de	nil
imgkid.com	nil
065b42ba2b.se	nil
somo.vn	nil
biglion.ru	nil
bebee.com	nil
zenfolio.com	nil
pier1.com	nil
awd.ru	nil
ekitan.com	nil
betboo539.com	nil
ilpost.it	nil
denverpost.com	nil
vartoken.com	nil
santander.com.mx	nil
propellerads.com	nil
rcom.co.in	nil
telegraf.rs	nil
logme.in	reject	agari
foodandwine.com	nil
islamicfinder.org	nil
tworld.co.kr	nil
wholefoodsmarket.com	nil
serebii.net	nil
realclearpolitics.com	nil
astromenda.com	nil
biz-journal.jp	nil
mongodb.org	nil
revolveclothing.com	nil
750g.com	nil
snapfish.com	nil
thepaper.cn	nil
apa.org	nil
youngliving.com	nil
pomponik.pl	nil
hasoffers.com	nil
pagalworld.com	nil
laravel.com	nil
youthwant.com.tw	nil
jwplayer.com	nil
elnuevodia.com	nil
ip138.com	nil
alza.cz	nil
convio.com	nil
dodocook.com	nil
gov.kz	nil
greenmangaming.com	nil
zando.co.za	nil
gamebomb.ru	nil
immoral.jp	nil
metrodeal.com	nil
majikichi.com	nil
yoast.com	nil
kinokrad.net	nil
semalt.com	nil
bitterstrawberry.org	nil
allanalpass.com	nil
acm.org	nil
volkskrant.nl	nil
pf178.com	nil
alkislarlayasiyorum.com	nil
skyscanner.com	nil
google.com.ly	reject	self:google
myspservices.com	nil
mgstage.com	nil
dream.co.id	nil
avsforum.com	nil
townhall.com	nil
secure.ipage.com	nil
nttxstore.jp	nil
fruitmail.net	nil
uncomo.com	nil
abelhas.pt	invalid
jumia.com	nil
1nimo.com	nil
spreadshirt.com	nil
esprit.de	nil
gofeed2all.eu	nil
godvine.com	nil
vocabulary.com	nil
lesoir.be	nil
eurosport.ru	nil
allstate.com	nil
philstar.com	nil
cams.com	nil
netzwelt.de	nil
techinasia.com	nil
ohnotheydidnt.livejournal.com	nil
infoq.com	nil
stuntoffer.com	nil
teamwork.com	nil
motogp.com	nil
collinsdictionary.com	nil
winbank.gr	nil
popcorntime.io	none	self
ntu.edu.tw	nil
xvideosmtm.com	nil
hemnet.se	nil
tedata.net	nil
manageyourloans.com	nil
metifar.com	nil
investors.com	nil
treehugger.com	invalid
codeschool.com	nil
rabehsaeed.com	nil
payza.com	monitor	self
pmu.fr	nil
torrentbest.net	nil
twentytwowords.com	nil
businessinsider.com.au	nil
twasul.info	nil
gov.on.ca	nil
hardware.fr	nil
zakon.kz	nil
pornleech.com	nil
hkjc.com	nil
startinghobbies.com	nil
koimoi.com	nil
p30world.com	nil
vip.tmall.com	nil
lanebryant.com	nil
gsmhosting.com	nil
thewirecutter.com	nil
volvocars.com	nil
acttv.in	nil
nlcafe.hu	nil
imgarcade.com	nil
famousfix.com	nil
seventeen.com	nil
trkads10.com	nil
goobike.com	nil
svt.se	nil
desitvbox.me	nil
finam.ru	nil
gsu.edu	nil
guru.com	nil
vedomosti.ru	nil
2054.info	nil
avazutracking.net	nil
customink.com	nil
todaypk.com	nil
colafile.com	nil
puritan.com	nil
techgig.com	nil
bugun.com.tr	nil
thewindowsclub.com	nil
hdwallpapers.in	nil
geek.com	nil
t24.com.tr	nil
nnm.me	invalid
songza.com	nil
jobmail.co.za	nil
atlas.sk	nil
binbox.io	nil
careesma.in	nil
belk.com	nil
oregonstate.edu	nil
poringa.net	invalid
naftemporiki.gr	nil
cr173.com	nil
nastygal.com	nil
ohio.gov	nil
bollywoodtabloid.com	nil
admin5.com	nil
subtitles.at	nil
searchingresult.com	invalid
hawahome.com	nil
infox.sg	nil
searchmetrics.com	nil
q.cc	nil
mp3fil.biz	nil
sfimg.com	nil
afpbb.com	nil
minkchan.com	nil
pinggu.org	nil
vkmag.com	nil
inboxdollars.com	reject	returnpath,unknown:dmarc_feedback@cotterweb.net,unknown:dmarc_forensic@cotterweb.net
blogspot.fi	none	self:google
tomshw.it	nil
mrskin.com	nil
koreayellowpage.net	nil
pbworks.com	invalid
fastmail.com	invalid
ufc.com	nil
gfxfree.net	nil
gameinformer.com	none	self
sas.com	nil
csod.com	nil
nola.com	nil
ldlc.com	nil
95599.cn	nil
kakprosto.ru	nil
paginasamarillas.es	nil
cpubenchmark.net	nil
tnt.com	nil
auctiva.com	nil
climatempo.com.br	nil
americatv.com.pe	nil
visual.ly	nil
gametwist.com	nil
amarillasinternet.com	nil
hitfix.com	nil
mrexcel.com	nil
yamaha.com	nil
huffingtonpost.in	nil
firestorage.jp	nil
aviasales.ru	nil
aitnews.com	nil
kasikornbankgroup.com	nil
onelogin.com	nil
n44adshostnet.com	nil
amadeus.com	nil
hasznaltauto.hu	nil
kongfz.com	nil
axeso5.com	invalid
uszcn.com	nil
parallels.com	none	
bloodyelbow.com	nil
meteo.pl	nil
tuikuan.tmall.com	nil
state.fl.us	nil
anadolu.edu.tr	nil
carspoon.com	nil
entertainmentceleb.com	nil
bakaav.com	nil
sciencenet.cn	nil
velvet.hu	nil
sharethis.com	nil
anntaylor.com	nil
tiramillas.net	nil
xml-sitemaps.com	nil
warau.jp	nil
media.wix.com	nil
theclymb.com	nil
socialblade.com	nil
rus.ec	nil
timesofisrael.com	none	self
edgesuite.net	nil
proz.com	none	self
o-mi.ru	nil
cam4.es	nil
dicio.com.br	nil
cancer.org	nil
filezilla-project.org	invalid
6vhao.com	nil
topito.com	nil
tripit.com	nil
dpd.de	nil
7-themes.com	nil
freecontact.com	nil
jobkorea.co.kr	nil
nomura.co.jp	nil
alalam.ir	nil
insight.ly	nil
download-genius.com	nil
hellowork.go.jp	nil
99.com.cn	nil
dtdc.com	nil
kym-cdn.com	nil
timesofoman.com	nil
epicscanpronice.in	nil
peoplestylewatch.com	nil
dailynayadiganta.com	nil
plus28.com	nil
byr.cn	nil
18touch.com	nil
photoyoum7.com	nil
euro.com.pl	nil
libreoffice.org	nil
kaixin001.com	nil
sify.com	nil
songily.com	nil
uptodate.com	nil
up.nic.in	nil
probuilds.net	nil
whois.net	nil
istgah.com	nil
norwegian.com	invalid
onlinesoccermanager.com	none	unknown:dmarc-aggregate@acervus.nl,unknown:dmarc-forensic@acervus.nl
brooksbrothers.com	nil
sofort.com	nil
tantannews.com	nil
colostate.edu	nil
82d914.se	nil
cutestat.com	nil
powtoon.com	nil
three.co.uk	nil
ololo.fm	nil
npo.nl	nil
infomoney.com.br	nil
tr-sanat.info	nil
actblue.com	nil
webrootanywhere.com	nil
royalcaribbean.com	nil
flyfrontier.com	nil
shopfacil.com.br	nil
7po.com	nil
timviecnhanh.com	nil
hotline.ua	nil
vozforums.com	nil
bankifsccode.com	nil
wikimart.ru	nil
entree.com	nil
gry.pl	nil
cartoonnetwork.com	nil
techonthenet.com	nil
ne10.uol.com.br	nil
lankadeepa.lk	nil
mec.gov.br	nil
sazedofyqar.com	nil
rd.com	nil
dn.no	nil
123greetings.com	none	unknown:sam@123greetings-inc.com,unknown:spoof.123greetings@gmail.com
liverpool.com.mx	nil
lily.camera	nil
sproutsocial.com	nil
earthporm.com	nil
televisao.uol.com.br	nil
scmp.com	nil
akamai.com	none	agari,self
leonbets.net	nil
anandabazar.com	nil
gossiplankanews.com	nil
geizhals.at	nil
gofeminin.de	nil
vseinstrumenti.ru	nil
t-online.hu	nil
61baobao.com	nil
fantagazzetta.com	nil
claro.com.br	nil
songtexte.com	invalid
mta.info	nil
unesco.org	nil
nginx.org	nil
9666.cn	nil
bestreams.net	nil
sensacine.com	nil
sportinglife.com	nil
webike.net	nil
sheypoor.com	nil
pinsta.me	nil
medicalnewstoday.com	nil
eonet.jp	nil
game-debate.com	nil
grotal.com	nil
vh1.com	nil
farsroid.com	nil
perfil.com.ar	nil
sportal.bg	nil
navient.com	nil
biquge.la	nil
padlet.com	invalid
bootsnipp.com	nil
bleepingcomputer.com	nil
cashkaro.com	nil
slaati.com	nil
ebc.com.br	nil
dinside.no	nil
pho.to	nil
fashion-algorithm.net	nil
binkiland.com	nil
mass.gov	nil
visa.com	quarantine	returnpath
zuanke8.com	nil
bnpparibasfortis.be	nil
boardingarea.com	nil
propertyguru.com.sg	nil
cucirca.eu	nil
mp3mad.com	nil
hatenablog.jp	nil
ibexnetwork.com	nil
dumpaday.com	nil
israbox.org	nil
eqla3.com	nil
traefllab.ru	nil
irannaz.com	nil
ap.gov.in	nil
wiggle.co.uk	nil
domainnamesales.com	nil
zapier.com	nil
lupoporno.com	nil
mirraw.com	nil
thehindubusinessline.com	nil
quto.ru	invalid
prosport.ro	nil
3c41ddc0.se	nil
hwupgrade.it	nil
computrabajo.com.co	nil
stumblemail.net	none	postmarkapp,unknown:jmoe@stumbleupon.com
hawaii.edu	nil
newsweek.com	nil
oodle.com	nil
bankersadda.com	nil
2iranfilm.com	nil
kupivip.ru	nil
checkthisyo.com	nil
aichuun.com	nil
salary.com	nil
paypop.org	nil
vbox7.com	nil
infojobs.com.br	nil
masturbate.jp	nil
afip.gov.ar	nil
pengpeng.com	nil
gamedog.cn	nil
howbuy.com	invalid
artofmanliness.com	nil
serienjunkies.de	nil
blogspot.hu	none	self:google
matadornetwork.com	nil
speakingtree.in	nil
key-find.com	nil
onlinebank.com	nil
banma.com	nil
koovs.com	nil
pjmedia.com	nil
brainpickings.org	nil
ethz.ch	nil
tsa-algerie.com	nil
zealer.com	none	self:netease
safaribooksonline.com	nil
wral.com	nil
hikaritv.net	nil
yurticikargo.com	nil
ppy.sh	nil
libsyn.com	nil
porn5.com	nil
aviny.com	nil
shorouknews.com	nil
pcgames.com.cn	nil
tryboobs.com	nil
francetv.fr	nil
rasekhoon.net	nil
registro.br	nil
fundsxpress.com	nil
kupujemprodajem.com	nil
quizzitch.net	nil
indiafreestuff.in	nil
wikitree.co.kr	nil
warthunder.com	nil
star-conflict.com	nil
cyberpresse.ca	nil
dnevnik.ru	nil
memecenter.com	nil
healthkart.com	nil
clickhole.com	nil
thesportstream.com	nil
fl.ru	invalid
trivago.de	nil
pagesperso-orange.fr	nil
shafaqna.com	nil
altyazi.org	nil
seansik.tv	nil
gaymaletube.com	nil
rome2rio.com	nil
24smi.org	nil
seedit.com	nil
webmail-seguro.com.br	nil
skyscanner.ru	nil
tengrinews.kz	nil
moonsy.com	nil
sovsport.ru	nil
autotrader.ca	nil
telderi.ru	invalid
ohmynews.com	nil
brndrm.com	nil
drako.ru	nil
globalsources.com	none	self
bt.dk	nil
huaren.us	nil
pearson.com	nil
adlure.net	nil
djangoproject.com	nil
vodafone.co.uk	nil
zalando.fr	nil
chanet.com.cn	nil
mangatown.com	nil
newegg.cn	nil
powned.tv	nil
dietnavi.com	nil
fourhourworkweek.com	invalid
nipple-img.com	nil
povarenok.ru	nil
koreanair.com	nil
cue-monitor.jp	nil
burusoku-vip.com	nil
cancan.ro	nil
rapidtables.com	nil
muffingroup.com	nil
retre.org	nil
timeweb.ru	nil
m24.ru	nil
translate.ru	nil
saksoff5th.com	nil
experiandirect.com	nil
band.uol.com.br	nil
gsis.gr	nil
avery.com	none	returnpath
wdr.de	nil
aljarida.com	nil
demonoid.pw	nil
belastingdienst.nl	none	self
jia360.com	nil
lululemon.com	nil
consumeraffairs.com	nil
calottery.com	nil
add-anime.net	nil
hsbc.com.br	none	agari
fluege.de	nil
topcashback.com	none	dmarcian,unknown:emailmonitoring@topcashback.co.uk
com-secure.org	nil
mymp3song.com	nil
partycity.com	nil
convertunits.com	nil
alpha.gr	nil
serienjunkies.org	nil
ixigo.com	nil
365jilin.com	nil
ufx.com	nil
xdating.com	reject	self
pideo.net	nil
zyngagames.com	nil
seatguru.com	nil
equifax.com	nil
forex.com.cn	nil
venere.com	nil
aflrm.com	nil
lacuerda.net	nil
otodom.pl	invalid
boulanger.com	nil
cinykydypog.com	nil
startbootstrap.com	nil
rcgroups.com	nil
topgear.com	nil
meteo.gr	nil
indonetwork.co.id	invalid
grupobancolombia.com	nil
filmey.com	nil
soundhouse.co.jp	nil
cgd.pt	nil
mmamania.com	nil
emailsrvr.com	nil
ttt4.com	nil
myuhc.com	nil
l-tike.com	nil
freshdesignweb.com	nil
galleryhip.com	nil
swtor.com	nil
internations.org	nil
optymalizacja.com	nil
mozilla.net	nil
vecteezy.com	nil
pandora.net	none	dmarcian
clicnscores.com	nil
christianbook.com	none	self
babycentre.co.uk	nil
onlain-porno.tv	nil
crntt.com	nil
icubeswire.com	nil
softonic.it	nil
panerabread.com	nil
eiga.com	nil
segmentfault.com	nil
aldi-sued.de	nil
lavenir.net	nil
klikdokter.com	nil
sdchina.com	nil
ksu.edu.sa	nil
metaffiliation.com	nil
du.ac.in	nil
byu.edu	nil
pckeeper.com	reject	self
joomlart.com	nil
vatera.hu	nil
web-hosting.com	nil
pubdirecte.com	nil
k12.ga.us	nil
dzwww.com	nil
thaiseoboard.com	nil
eobot.com	nil
oa.com	nil
draftkings.com	nil
runescape.com	reject	unknown:sysadmin@jagex.com
celebrityhq.com	nil
systemrequirementslab.com	nil
webofknowledge.com	nil
bodmillenium.com	nil
mangapark.me	nil
pornburst.xxx	nil
arsenal.com	nil
kino-teatr.ru	nil
proxfree.com	nil
heureka.sk	nil
clker.com	nil
gotquestions.org	nil
rajasthan.gov.in	nil
ymlp.com	nil
zhubajie.com	nil
christianpost.com	nil
51wan.com	nil
maxifoot.fr	nil
share-links.biz	nil
kiabi.com	nil
holidaylettings.co.uk	nil
skyperfectv.co.jp	nil
eprice.it	nil
dawnnews.tv	nil
nerdwallet.com	nil
tsinghua.edu.cn	nil
crowdfireapp.com	nil
ionicframework.com	nil
runetki.tv	nil
baicaio.com	nil
downloadatoz.com	nil
buzzgfx.com	nil
poradnikzdrowie.pl	nil
iheartdogs.com	nil
pclab.pl	nil
bhinneka.com	nil
51bi.com	nil
video-dom2.ru	nil
zalando.pl	nil
spring.io	nil
babebuns.com	nil
torrentproject.se	nil
tableau.com	nil
wasu.cn	nil
forextops.com	nil
cam4.fr	nil
picresize.com	nil
alrakoba.net	nil
moneyforward.com	nil
watchfree.to	nil
nikkei.co.jp	nil
fotomac.com.tr	nil
eplus.jp	nil
mytoys.de	nil
articlesbase.com	nil
plius.lt	nil
movoto.com	nil
bossip.com	invalid
ricardoeletro.com.br	reject	returnpath
sportschau.de	nil
newser.com	nil
topxlive.com	nil
gucci.com	nil
birchbox.com	nil
craveonline.com	nil
olx.bg	nil
k12.com	nil
220-volt.ru	nil
synonym.com	nil
jobereqs.com	nil
geekbuying.com	nil
softlayer.com	none	self
countryliving.com	nil
education.com	nil
topuniversities.com	nil
wapka.me	nil
fullhdfilmizle.org	nil
superpages.com	nil
brainfall.com	nil
theoldreader.com	nil
phimmoi.net	nil
ladenzeile.de	nil
manmanbuy.com	nil
antaranews.com	nil
weeb.tv	invalid
practo.com	nil
calciomercato.com	nil
hamshahrionline.ir	nil
skai.gr	nil
ecplaza.net	nil
logic-immo.com	nil
dreamsearch.or.kr	nil
bezaat.com	none	unknown:dmarc@mailinblue.com!10m
animefreak.tv	nil
elle.fr	nil
fin24.com	nil
bni.co.id	nil
justclick.ru	reject	
minoland.com	nil
getterstory.com	nil
topwar.ru	nil
mastermovie-hd.com	nil
airfrance.fr	nil
sdo.com	nil
diary.ru	nil
wareztuga.tv	nil
xydesefyriq.com	nil
onet.tv	nil
trovit.com	nil
futjakot.al	nil
matomeja.jp	nil
webaslan.com	nil
wikisource.org	nil
2ip.ru	nil
elcorreo.com	nil
jn.pt	nil
farnell.com	nil
hipertextual.com	nil
olhardigital.uol.com.br	nil
s-oman.net	nil
shatel.ir	nil
doctoroz.com	none	agari
bookzz.org	nil
musicaneh.ir	nil
immoweb.be	nil
htmlpublish.com	nil
tvsubtitles.net	nil
mypcbackup.com	nil
o2.co.uk	nil
m3.com	nil
pearsonmylabandmastering.com	nil
louisvuitton.com	nil
viralands.com	nil
wordfind.com	nil
tagesspiegel.de	nil
lyricsmint.com	nil
mkyong.com	nil
ucm.es	nil
thetimes.co.uk	nil
thesun.co.uk	nil
hewitt.com	nil
whatseek.com	nil
uplea.com	nil
thebestbookies.com	nil
healthcare.gov	nil
unsplash.com	nil
anige-sokuhouvip.com	nil
bittorrent.com	nil
ad-link.jp	nil
military.com	nil
csair.com	nil
cincodias.com	nil
ivoox.com	nil
sfora.pl	nil
alfemminile.com	nil
lineq.jp	nil
3suisses.fr	nil
xiachufang.com	nil
style.com	nil
dip.jp	nil
dn.pt	nil
itslearning.com	nil
fxstreet.com	nil
1and1.co.uk	nil
mec.es	nil
alnaharegypt.com	nil
rxlist.com	nil
fastweb.it	nil
relianceada.com	nil
amazing.com	nil
mobileosalert.com	nil
cncv.org.cn	nil
matome-plus.com	nil
google.cm	none	self:google
11185.cn	nil
ipaddress.com	nil
mtb.com	none	agari
covoiturage.fr	nil
blair.com	invalid
bravotv.com	nil
cwan.com	nil
medindia.net	nil
kriesi.at	nil
bible.com	nil
informador.com.mx	nil
beget.ru	nil
05tz2e9.com	nil
escapistmagazine.com	nil
in.gov	nil
xe.gr	nil
nchsoftware.com	nil
homestead.com	nil
spa.gov.sa	nil
lyst.com	nil
diytrade.com	nil
meristation.com	nil
schema.org	none	self:google
opensubtitles.website	nil
stream-tv1.net	nil
pravda.sk	nil
key.com	none	agari
bunshun.jp	nil
leggo.it	nil
stack.com	nil
sigmaaldrich.com	nil
thestudentroom.co.uk	nil
inccel.com	nil
vipergirls.to	nil
pensador.uol.com.br	nil
nicoblomaga.jp	nil
zyalt.livejournal.com	nil
checkpagerank.net	nil
bangkokpost.com	nil
linuxmint.com	nil
experian.com	nil
fontanka.ru	nil
sudouest.fr	nil
mobilism.org	nil
epson.jp	nil
dotamax.com	nil
latercera.cl	nil
1and1.es	nil
pwc.com	none	self
electracard.com	nil
gnula.nu	nil
ge.com	nil
backlinko.com	nil
prweb.com	none	unknown:dmarc@vocus.com
zbozi.cz	nil
fujitsu.com	nil
manuscriptcentral.com	reject	
lookbook.nu	nil
gordonua.com	nil
ing.be	reject	dmarcian,self
sucuri.net	nil
geni.com	nil
seomastering.com	nil
kabeldeutschland.de	nil
rotahaber.com	nil
bytes.com	nil
mytatasky.com	nil
elo7.com.br	nil
888media-ru.com	nil
boe.es	nil
madrid.org	nil
potora.jp	nil
ebs.in	nil
bomnegocio.com	nil
buzzorange.com	nil
pr.gov.br	nil
tractorsupply.com	none	self
downvids.net	nil
ah.nl	nil
torrent-anime.com	nil
westlaw.com	nil
heraldcorp.com	nil
nukistream.com	nil
orange.co.uk	nil
biblestudytools.com	nil
bochk.com	nil
notdoppler.com	nil
astro.com	nil
thepiratebay.cd	nil
thrillreel.com	nil
android-hilfe.de	nil
ahlynews.com	nil
harley-davidson.com	none	self
monoprice.com	nil
tubekittysexe.com	nil
posta.com.tr	nil
travelchannel.com	nil
top10homeremedies.com	nil
townwork.net	nil
snob.ru	nil
appcrawlr.com	nil
kboing.com.br	nil
lordandtaylor.com	nil
toster.ru	nil
bathandbodyworks.com	nil
10bet.com	nil
95095.com	nil
containerstore.com	nil
glopart.ru	nil
centauro.com.br	nil
astrosage.com	nil
en-japan.com	nil
paisdelosjuegos.com.mx	nil
stereogum.com	nil
vrisko.gr	nil
bitcointalk.org	nil
newsone.gr	nil
turkcebilgi.com	nil
cps.com.cn	nil
gimp.org	nil
sermepa.es	nil
mobile9.com	nil
oreillyauto.com	nil
dtvideo.com	nil
artlebedev.ru	nil
appgame.com	nil
filmfanatic.com	nil
zivame.com	nil
gavick.com	nil
coco.fr	nil
vesti-ukr.com	nil
yiiframework.com	nil
senego.com	nil
targetingadvertiser.com	nil
tjx.com	nil
kkiste.to	nil
guangdiu.com	nil
quicksystemcash.com	nil
stream-tv-series.net	nil
pearltrees.com	reject	self,dmarcian
coinbase.com	reject	agari,dmarcian
atv.com.tr	nil
novafile.com	nil
nuevoloquo.com	nil
reserveamerica.com	nil
greatschools.org	nil
wayn.com	nil
hypovereinsbank.de	nil
internetslang.com	nil
iimjobs.com	nil
fewo-direkt.de	reject	agari,haspf
alhayat.com	nil
ray-ban.com	none	
teenee.com	nil
yourtango.com	nil
christiantoday.com	nil
smartresponder.ru	reject	self
arabi21.com	nil
travelandleisure.com	nil
advego.ru	nil
futurelearn.com	nil
usf.edu	nil
antenam.biz	nil
thepioneerwoman.com	nil
upsc.gov.in	nil
iherb.cn	nil
bbs-tw.com	nil
bolshoyvopros.ru	nil
depor.pe	nil
x-art.com	nil
mps.it	nil
edublogs.org	nil
prcm.jp	nil
realgm.com	none	self
cengage.com	nil
jobstreet.com.my	nil
444.hu	nil
creativecow.net	nil
oyorooms.com	nil
micromaxinfo.com	nil
icefilms.info	nil
reimagenetwork.com	nil
elotrolado.net	nil
zocdoc.com	nil
watchstore.com.cn	nil
starsunnysetgadget.in	nil
myfedloan.org	nil
copyop-ads.com	nil
bzwbk.pl	nil
correos.es	nil
9ku.com	nil
blogspot.no	none	self:google
teensnow.com	nil
meta.ua	invalid
search.us.com	nil
tv3.lt	nil
americanlisted.com	nil
snapdo.com	nil
peopleclick.com	nil
soft112.com	nil
splendidoffer45.com	nil
spartoo.com	nil
mgm.gov.tr	nil
wo.com.cn	nil
googledrive.com	none	self:google
avsow.com	nil
maduradas.com	nil
love.fr	nil
ads.id	nil
rarbg.com	nil
tradingview.com	nil
lavoz.com.ar	nil
gartner.com	nil
yahoo-help.jp	nil
pianetadonna.it	nil
ok-magazine.com	nil
wickes.co.uk	nil
fling.com	nil
buydig.com	quarantine	self
nedsecure.co.za	nil
mulher.uol.com.br	nil
55bbs.com	nil
unieuro.it	nil
sunbet5555.com	nil
decipherinc.com	none	self
alphacoders.com	nil
jango.com	nil
paperpkblog.com	nil
tovima.gr	nil
acer.com	nil
listentoyoutube.com	nil
tolexo.com	nil
wtfast.com	nil
indiansexxxtube.com	nil
reg.ru	none	self
whitepinsplus.com	nil
safemls.net	nil
ftchinese.com	nil
uiowa.edu	nil
adata.com	nil
bluegratin.xyz	nil
linxpays.com	nil
crosswalk.com	nil
48fd4acf12b.se	nil
mdn2015x2.com	nil
humana.com	none	self
tower.jp	nil
budget.com	nil
stayfriends.de	nil
redmondpie.com	nil
htmlgoodies.com	nil
osym.gov.tr	nil
coursehero.com	nil
hnjy.com.cn	nil
uaewomen.net	nil
jst.go.jp	nil
fastunitdatagood.name	nil
siemens.com	nil
foxbusiness.com	nil
startv.com.tr	nil
meteociel.fr	nil
bit.ly	none	self
onekingslane.com	nil
thesimsresource.com	nil
computeruniverse.net	nil
kleiderkreisel.de	nil
full-stream.me	nil
daveramsey.com	nil
shopping.uol.com.br	nil
groupme.com	nil
dzsc.com	nil
setopati.com	nil
topcashback.co.uk	invalid
anthem.com	none	unknown:anthem_rua@dm.easysol.net,unknown:anthem_ruf@dm.easysol.net
22.cn	invalid
rosewholesale.com	nil
sahafah.net	nil
payline.ir	nil
123haitao.com	nil
iastate.edu	nil
designtaxi.com	nil
watchcric.net	nil
price.com.hk	invalid
stc.com.sa	nil
verticalresponse.com	nil
komputerswiat.pl	nil
theladders.com	nil
safelinkconverter.com	nil
nodejs.org	nil
ename.com	nil
coach.com	nil
futbol24.com	nil
eloqua.com	nil
en.wordpress.com	nil
blizko.ru	nil
sun-gazing.com	nil
enom.com	nil
wild-fly.net	nil
mbs-potsdam.de	nil
abcya.com	nil
bestwestern.com	nil
moo.com	nil
riverisland.com	nil
entireweb.com	nil
kobobooks.com	nil
rateyourmusic.com	invalid
novaposhta.ua	none	self
fullprogramlarindir.com	nil
aeropostale.com	nil
mtnews24.com	nil
hostgator.in	nil
nutristic.com	nil
pichunter.com	nil
zapimoveis.com.br	nil
simplesite.com	nil
it-ebooks.info	nil
nordea.se	nil
baur.de	nil
videowood.tv	nil
vistaprint.in	none	returnpath,unknown:prodrua@vistaprint.com
rp.pl	nil
jiemian.com	nil
sharebeast.com	nil
192.com	none	self
olx.com.co	nil
davidwalsh.name	nil
ecosia.org	nil
jugantor.com	nil
swansonvitamins.com	nil
tonarinoyj.jp	nil
sliptalk.com	nil
hatelabo.jp	nil
fashionitch.com	nil
cuantarazon.com	nil
naturum.ne.jp	invalid
djjohal.com	nil
nextbigwhat.com	nil
pcgameshardware.de	nil
go108.com.cn	nil
gladiators.com	nil
minutebuzz.com	nil
kure.tv	nil
farecompare.com	nil
radiotimes.com	nil
rakuten.tw	nil
bitdefender.com	nil
urban-rivals.com	nil
football.ua	nil
juwai.com	nil
volaris.com	nil
mejorconsalud.com	nil
forum-auto.com	nil
redamateurtube.com	nil
ioffer.com	nil
pubmatic.com	nil
evolife.cn	nil
neeu.com	nil
berliner-sparkasse.de	nil
omgtorrent.com	nil
funcloud.com	nil
fragrantica.com	nil
totheglory.im	nil
beliefnet.com	nil
sfbest.com	nil
youmob.com	nil
mapsofworld.com	nil
400gb.com	nil
wine-searcher.com	nil
credoaction.com	nil
finya.de	nil
webinarjam.net	nil
snapwidget.com	nil
whoscored.com	nil
msecnd.net	nil
jacquieetmicheltv.net	nil
nudevista.tv	nil
kw.com	nil
oddschecker.com	nil
jr-odekake.net	nil
askme.com	nil
webstaurantstore.com	nil
searchengine.us	nil
fantasti.cc	nil
indiegala.com	nil
wetplace.com	nil
zju.edu.cn	nil
blog.pl	nil
siilu.com	nil
lidl.pl	nil
transrush.com	nil
85dcf732d593.se	nil
dailymegabyte.com	nil
themelock.com	nil
movie-blog.org	nil
laracasts.com	nil
matichon.co.th	nil
port.hu	nil
1234567.com.cn	nil
arenabg.com	nil
miamiherald.com	nil
crackberry.com	nil
flashback.org	nil
michaelkors.com	nil
i-doxs.net	nil
lindito.com	nil
47news.jp	nil
onlainfilm.ucoz.ua	nil
fb.org	nil
nissan.co.jp	nil
istethmar.net	nil
hanjin.co.kr	nil
appfolio.com	nil
tokyo-tube.com	nil
calculator.net	nil
lendingclub.com	none	self,returnpath
arabstoday.net	nil
pipaw.com	nil
seochat.com	nil
dicionarioinformal.com.br	nil
meijer.com	nil
polar.com	nil
taxheaven.gr	nil
bancopopular.es	nil
snip.ly	nil
sarizeybekhaber.com.tr	nil
wehkamp.nl	nil
di.se	nil
filmizlesene.com.tr	nil
inhabitat.com	nil
createsend.com	nil
academy.com	nil
crobo.com	nil
ebay.com.hk	none	agari,returnpath
bplans.com	nil
f8350e7c1.se	nil
jeux.fr	nil
rediffmail.com	nil
leclercdrive.fr	nil
record.com.mx	nil
trome.pe	nil
cliffsnotes.com	nil
glassdoor.co.in	nil
roshd.ir	nil
cerdas.com	nil
template-help.com	nil
farhangnews.ir	nil
flawless.com	nil
sportsmanias.com	nil
tubepornup.com	nil
shopotam.ru	nil
0aac4e6a54c170b0.se	nil
allbest.ru	nil
gardeningknowhow.com	nil
arabictorrent.net	nil
firmy.cz	nil
tnttorrent.info	nil
dagospia.com	nil
h33t.to	nil
apotheken-umschau.de	nil
promocodeclub.com	nil
firefox.com	none	self
getnews.jp	nil
politikus.ru	nil
smartprofits.org	nil
dfiles.eu	nil
adsmktng.net	nil
bls.gov	nil
namasthetelangaana.com	nil
iranecar.com	nil
tameteo.com	nil
translit.net	nil
google.org	none	self:google
mlstatic.com	nil
manabadi.co.in	nil
pitt.edu	nil
marketingland.com	nil
rotapost.ru	nil
blogspot.ch	none	self:google
celebuzz.com	nil
genieo.com	nil
tagesanzeiger.ch	nil
feebee.com.tw	nil
akbank.com	nil
ncore.cc	quarantine	self
hasbro.com	nil
uc.cn	nil
oglaf.com	nil
tmtpost.com	nil
guru3d.com	nil
gooddrama.net	nil
payless.com	nil
dstv.com	nil
tickets.com	nil
topsy.com	nil
investingarabs.com	nil
walmart.com.mx	nil
avangard.ru	nil
weedia.tv	nil
a8.net	nil
dregol.com	nil
conforama.fr	nil
mercadolibre.com.uy	nil
wfaa.com	nil
s3.com.tw	nil
post.gov.tw	nil
drdinl.jp	nil
hallmark.com	nil
taste.com.au	nil
cecile.co.jp	nil
ntlworld.com	nil
animeflavor.com	nil
firstdirect.com	none	agari
cybozu.com	nil
link-assistant.com	nil
searchquotes.com	nil
surfearner.com	nil
onlinemoviewatchs.com	nil
nn.ru	nil
ge.tt	nil
jumia.ma	nil
trendmicro.com	none	self
slashgear.com	nil
bestbooklibrary.com	nil
consumerist.com	invalid
toofab.com	nil
payeer.com	nil
eurobank.gr	nil
wondershare.com	nil
myus.com	nil
mom.me	nil
adfoc.us	nil
epochtimes.com	nil
cinepolis.com	nil
justia.com	nil
1and1.fr	nil
toms.com	nil
mrporter.com	nil
studentdoctor.net	quarantine	dmarcanalyzer
googleplex.com	nil
doviz.com	nil
sol.org.tr	nil
omelete.uol.com.br	nil
foreningssparbanken.se	nil
sharefile.com	nil
comixology.com	nil
estekhtam.com	nil
cognizant.com	none	postmarkapp
charlotterusse.com	nil
sinembargo.mx	nil
telenet.be	nil
tim.it	nil
virginamerica.com	nil
immihelp.com	nil
rbc.ua	invalid
reklama5.mk	nil
wanyx.com	nil
netmile.co.jp	nil
prozeny.cz	nil
shopgoodwill.com	nil
soonnight.com	nil
2shared.com	nil
staples.ca	nil
hubspot.net	nil
google.al	reject	self:google
routard.com	nil
technews.tw	nil
si.edu	nil
state.mn.us	nil
bmwusa.com	nil
lexisnexis.com	none	agari
yeahmobi.com	nil
info.com	nil
coderanch.com	nil
zakupki.gov.ru	nil
lolskill.net	nil
hkepc.com	nil
bitrix24.ru	nil
trak.in	nil
movie2k.tl	nil
dsebd.org	nil
gemius.com	nil
onegreenplanet.org	nil
excite.com	nil
warriorplus.com	nil
expedia.de	nil
securesuite.co.uk	nil
fastunitdatagood.in	nil
prisjakt.nu	nil
phim3s.net	nil
torrentfunk.com	nil
com-work-from-home.pw	nil
sexlog.com	nil
ftd.com	nil
sunnyskyz.com	nil
crichd.in	nil
indiastudychannel.com	nil
gob.cl	nil
dynamicdrive.com	nil
tripleclicks.com	nil
nextag.com	nil
laprensa.com.ni	nil
fotocommunity.de	nil
job.ru	nil
tz.de	nil
anonymouse.org	nil
ad-center.com	nil
komputronik.pl	nil
manga-zone.org	nil
jstv.com	nil
huya.com	nil
legendas.tv	nil
handycafe.com	nil
tubepleasure.com	nil
nix.ru	nil
xhamsterhq.com	nil
bhu.co.kr	nil
streamate.com	none	unknown:dmarc-reports@flyingcroc.net,unknown:dmarc-abuse-reports@flyingcroc.net
dutchsinse.com	nil
foreca.com	nil
rtl.be	nil
makeshop.jp	nil
slutfinder.com	nil
ohmymag.com	nil
lolipop.jp	nil
adage.com	nil
usa.gov	nil
znanija.com	nil
ca800.com	nil
cigna.com	nil
yes123.com.tw	nil
uoregon.edu	nil
auto-profit-replicator.com	nil
allsingaporestuff.com	nil
veritenews.com	nil
portail.free.fr	nil
radiofarda.com	nil
g9.co.kr	nil
arubanetworks.com	none	self
zorpia.com	reject	self
adk2.net	nil
sgcpanel.com	nil
adultwork.com	nil
xxxhost.me	nil
freepik.es	nil
subtitulos.es	nil
sprashivai.ru	nil
hyundai.com	nil
medallia.com	none	self
onvista.de	nil
bonprix.ru	nil
authoritynutrition.com	nil
dropcam.com	nil
etnews.com	nil
northerntool.com	nil
orlandosentinel.com	nil
profitforest.com	nil
barrons.com	nil
hotair.com	nil
24tv.ua	nil
yesmessenger.com	invalid
wangtu.com	nil
plenti.com	reject	returnpath
money-birds.com	nil
light-dark.net	nil
jobstreet.co.id	nil
kaola.com	nil
asahi-net.or.jp	nil
yootheme.com	nil
cqsq.com	nil
ckfu.org	nil
developpez.net	nil
thereport24.com	nil
javatpoint.com	nil
mery.jp	nil
051jk.com	nil
smarturl.it	nil
suomi24.fi	nil
yw56.com.cn	nil
jeanmarcmorandini.com	nil
sehiba.com	nil
parsine.com	nil
makeupalley.com	nil
bitrix24.com	nil
technopoint.ru	nil
akibablog.net	nil
airbnb.fr	reject	self
torrentkitty.org	nil
yidio.com	nil
javarchive.com	nil
wooribank.com	nil
zdbb.net	nil
epicscanpronice.name	nil
nesine.com	invalid
onlinesbh.com	nil
paragonrels.com	nil
poki.com	nil
itesm.mx	nil
brand.tmall.com	nil
comodo.com	nil
megabus.com	nil
imgmega.com	nil
drive.ru	nil
runkeeper.com	none	dmarcian
topcpm.com	nil
nielsen.com	nil
litres.ru	none	dmarcian
ilovemobi.com	nil
player.pl	nil
abc7.com	nil
pr0gramm.com	nil
1999.co.jp	nil
netcombo.com.br	nil
ncsecu.org	nil
photodune.net	invalid
today.it	nil
servis24.cz	nil
1c-bitrix.ru	nil
teambeachbody.com	nil
nga.cn	nil
acehardware.com	nil
astrology.com	nil
imgbabes.com	nil
yoob.com	nil
licindia.in	nil
newmobilelife.com	nil
xxxfuckporn.com	nil
tarafdari.com	nil
businessnewsdaily.com	nil
ewirn45.com	nil
asianetnews.tv	nil
whatmobile.com.pk	nil
heroku.com	none	agari
shaw.ca	none	self
thetechsquash.com	nil
worktile.com	nil
larepublica.pe	nil
nanobank24.com	nil
bestwebnutfunblack.in	nil
my-personaltrainer.it	nil
buy123.com.tw	nil
virtualedge.com	none	agari
xxxdessert.com	nil
rsc.org	nil
bfd69dd9.se	nil
surfingbird.ru	none	self
alitalia.com	nil
mobile.free.fr	nil
jotform.com	nil
williamhill.it	nil
vanderbilt.edu	nil
cmsite.co.jp	nil
disquscdn.com	nil
copyblogger.com	nil
elmercurio.com	nil
gongchang.com	nil
linkshop.com.cn	nil
diablofans.com	nil
pornorama.com	nil
showss.net	nil
nexon.co.jp	nil
eroantenna.com	nil
ucoz.net	nil
bancogalicia.com.ar	nil
applitrack.com	nil
lidl.it	nil
uidai.net.in	nil
chip.com.tr	nil
eprize.com	nil
starsunnysetgadget.name	nil
blibli.com	none	self
zumi.pl	nil
ebay.tv	nil
nitori-net.jp	nil
thefappening.so	nil
takshop91.biz	nil
youporngay.com	nil
rakuten.de	nil
microsoftvirtualacademy.com	invalid
cpuboss.com	nil
searchfunmoods.com	nil
on24.com	nil
google.sn	none	self:google
ilcorsaronero.info	nil
goinf.ru	nil
sportsnavi.com	nil
pushbullet.com	nil
idokep.hu	nil
torrenters.com	nil
javfor.me	nil
tanga.com	nil
home24.de	nil
asos.de	nil
noticiasdelmundo.org	nil
666nf.com	nil
tati.fr	nil
nju.edu.cn	nil
geneanet.org	none	self
raiffeisen.ru	nil
39yst.com	nil
xyu.tv	nil
kadinlarkulubu.com	nil
matchesfashion.com	nil
dcfever.com	nil
closermag.fr	nil
wishpond.com	nil
brands4friends.de	nil
mingpao.com	nil
kaymu.com.ng	nil
oakley.com	nil
myfico.com	nil
bookoffonline.co.jp	nil
homecompleteblue.in	nil
ihualun.com	nil
komonews.com	nil
lintas.me	nil
morpakampus.com	nil
24.ae	nil
stamps.com	nil
gva.es	nil
savenkeep.com	nil
har.com	invalid
romaniatv.net	nil
bancochile.cl		
ticketfly.com	nil
lemall.com	nil
virtualbox.org	nil
local.ch	nil
plp.cl	nil
chrome.com	none	self:google
23wx.com	nil
ovguide.com	nil
lunapic.com	nil
babyou.com	nil
gyakorikerdesek.hu	nil
sweetpacks.com	nil
viber.com	nil
slon.ru	nil
gmx.ch	nil
becu.org	none	agari
ed.ac.uk	nil
e621.net	nil
the-fashion-method.com	nil
gentside.com	nil
freeonlinegames.com	nil
blogcms.jp	nil
geo.tv	nil
tower.im	nil
cafebazaar.ir	nil
apktops.ir	nil
flightstats.com	nil
livememe.com	nil
www.ne.jp	nil
attracta.com	nil
settrade.com	nil
datpiff.com	nil
koreus.com	nil
yudu.com	nil
2dehands.be	none	dmarcian
bollywoodshaadis.com	nil
hafiz.gov.sa	nil
radio-canada.ca	nil
xiaoshuomm.com	nil
behindthename.com	nil
dha.com.tr	nil
w3p.la	nil
trend.az	nil
thesuperficial.com	nil
goarticles.com	nil
jimmyjohns.com	nil
crackle.com	nil
cntraveler.com	nil
premium.wix.com	nil
games.co.id	nil
web.com	nil
navy.mil	nil
abs-cbn.com	nil
liftbump.com	nil
las2orillas.co	nil
mismarcadores.com	nil
foxsports.com.au	nil
movietube.co	nil
ibs.it	nil
newalbumreleases.net	nil
miltt.com	invalid
libgen.org	nil
valor.com.br	nil
virginmobileusa.com	nil
onlinemoviesgold.com	nil
indeed.co.za	nil
hitosara.com	nil
shopandship.com	nil
yalla-shoot.com	nil
activesearchresults.com	invalid
brasilescola.com	nil
satu.kz	nil
sublimetext.com	nil
expedia.co.in	nil
ymobile.jp	nil
livescores.com	nil
famousbirthdays.com	nil
fangraphs.com	nil
myftpupload.com	nil
quickanddirtytips.com	nil
mcdonalds.com	nil
cheshen.cn	nil
downloadhelper.net	nil
schulferien.org	nil
cooks.com	nil
theresumator.com	nil
buildhr.com	nil
leanporn.com	nil
directlyrics.com	nil
df.gob.mx	nil
filepuma.com	nil
politicususa.com	nil
decathlon.it	nil
datafilehost.com	nil
alukah.net	nil
dana.ir	nil
pcbaby.com.cn	nil
affsnetwork.com	nil
mmmoffice.com	nil
media.net	nil
reshareworthy.com	nil
missmalini.com	nil
seslisozluk.net	nil
macadogru.com	nil
jiwu.com	nil
axol.jp	nil
adac.de	nil
vectorstock.com	nil
che168.com	none	self:netease
ey.com	nil
lainformacion.com	nil
malaysiaairlines.com	nil
ahlamontada.com	nil
tw116.com	nil
pinstake.com	nil
astuce2015.com	nil
bershka.com	nil
the-village.ru	nil
mumsnet.com	nil
kayako.com	nil
publipt.com	nil
abckj123.com	nil
mangalam.com	nil
anz.com.au	nil
leroymerlin.pl	nil
telangana.gov.in	nil
wallstreetcn.com	nil
androidfilehost.com	nil
ru.wix.com	nil
saic.gov.cn	nil
chuandong.com	nil
2mnd56.com	nil
hastidownload.com	nil
cbse.nic.in	nil
nrc.nl	nil
newsday.com	nil
frandroid.com	nil
bayern.de	nil
clevelandclinic.org	nil
gh0089.com	nil
apk.tw	nil
subhd.com	nil
dinotube.com	nil
voeazul.com.br	nil
casualgameportal.com	nil
themindunleashed.org	nil
translated.net	none	dmarcian
jawharafm.net	nil
pinkbike.com	none	self
carrefour.es	nil
diarioregistrado.com	nil
yinxiang.com	reject	self
cpmterra.com	nil
nme.com	nil
uast.ac.ir	nil
chotot.vn	nil
redlink.com.ar	nil
sarenza.com	nil
panoramafirm.pl	nil
findicons.com	nil
banatstylegames.com	nil
depositfiles.org	nil
consumercomplaints.in	nil
qnap.com	nil
flightrising.com	nil
ency-education.com	nil
sophos.com	nil
crictracker.com	nil
pt.wix.com	nil
apherald.com	nil
tohotheater.jp	nil
tp-link.com	nil
noticiasrcn.com	nil
takuhai.jp	nil
wunderweib.de	nil
astrolords.ru	nil
paychex.com	none	agari,dmarcanalyzer
olx.ba	nil
kjendis.no	nil
watch32.is	nil
liberty.edu	nil
google.ge	reject	self:google
postgresql.org	nil
jamberrynails.net	nil
mspaintadventures.com	nil
morhipo.com	nil
telus.com	nil
smotri.com	nil
wpexplorer.com	nil
scene7.com	nil
yimg.jp	nil
indiblogger.in	nil
englishforums.com	nil
mobilix.eu	nil
wsu.edu	nil
theoutnet.com	nil
cinemark.com	nil
displayincloud.com	nil
localmoxie.com	nil
sextubefuck.com	nil
cbr.ru	nil
leadzupc.com	nil
ju51.com	nil
meteo.it	nil
twicsy.com	nil
businessofcinema.com	nil
onenote.com	nil
dot.gov	nil
gop.pk	nil
insomnia.gr	nil
rapidshare.com	nil
ad133m.com	nil
adoptapet.com	nil
82cook.com	nil
minq.com	nil
outsideonline.com	nil
easemytrip.com	nil
ucsc.edu	none	self
thekrazycouponlady.com	nil
shazam.com	nil
todaysppc.com	nil
secureadcenter.com	nil
valuewalk.com	nil
telerama.fr	nil
brit.co	nil
cheers.com.tw	nil
socialbakers.com	nil
pornper.com	nil
tfreeca.us	nil
postimage.org	nil
joxi.ru	nil
iwriter.com	nil
nation.co.ke	nil
apk4fun.com	nil
aftabnews.ir	nil
bux888.com	nil
ibuying.com	nil
problogger.net	nil
realmadrid.com	nil
cpmfx.com	nil
rhymezone.com	nil
trovit.it	nil
sgamer.com	nil
socialmediatoday.com	nil
onlinelic.in	nil
womanwithin.com	nil
letudiant.fr	nil
yllix.com	nil
iconnect.co.in	nil
nubiles.net	invalid
cgv.co.kr	nil
api.ning.com	nil
kproxy.com	nil
sudinfo.be	nil
leroymerlin.ru	nil
pap.fr	nil
trojmiasto.pl	nil
game4v.com	nil
dni.ru	nil
alwadifa-maroc.com	nil
okaz.com.sa	nil
frmtr.com	nil
freemovies.tv	nil
pluska.sk	nil
collegeboard.com	nil
seoclerk.com	nil
dildoxxxtube.com	nil
sendsay.ru	none	self
blox.pl	nil
voetbalzone.nl	nil
lesile.net	nil
lavdan.com	nil
hrsmart.com	nil
sid.ir	nil
rent.com	nil
ah-me.com	nil
cookthefood.com	nil
majorgeeks.com	nil
mtv.com.lb	nil
beatchucknorris.com	nil
his-j.com	nil
indeed.com.mx	nil
poshmark.com	nil
infoplease.com	invalid
baidu.co.th	nil
searspartsdirect.com	nil
bookmeter.com	nil
cargocollective.com	nil
kaufmich.com	nil
haaretz.co.il	nil
mrmlsmatrix.com	nil
gwdang.com	nil
dengekionline.com	nil
webartex.ru	nil
unext.jp	nil
websitewelcome.com	nil
online-stopwatch.com	nil
infoworld.com	nil
corsair.com	nil
toutiao.com	nil
bufferapp.com	reject	dmarcian
sbb.ch	nil
desire2learn.com	nil
memedeportes.com	nil
caringbridge.org	nil
bikewale.com	nil
kraftrecipes.com	nil
playgroundmag.net	none	self
shooshtime.com	nil
pep.com.cn	nil
nadaguides.com	nil
pciconcursos.com.br	nil
sharp.co.jp	nil
reforma.com	nil
bensbargains.com	nil
seriales.us	nil
okpussy.com	nil
techsupportalert.com	nil
hellporno.com	nil
anything2mp3.com	nil
remax.com	nil
kicktipp.de	nil
2banh.vn	nil
site5.com	nil
rockettheme.com	nil
mathtag.com	nil
jzb.com	nil
lushstories.com	nil
1hhhh.net	nil
crusharcade.com	nil
hecha.cn	nil
naukrigulf.com	invalid
malwaretips.com	nil
press24.mk	nil
prefiles.com	nil
marunadanmalayali.com	nil
axs.com	nil
vgtv.no	nil
noticias.com	nil
nokia.com	nil
aztecaporno.com	nil
hhs.gov	nil
uh.edu	nil
anibis.ch	nil
risingbd.com	nil
kumapon.jp	nil
readers.jp	nil
webconfs.com	nil
santanderbank.com	nil
uio.no	nil
games.com	nil
rezultati.com	nil
xxeronetxx.info	nil
materiel.net	nil
shorte.st	nil
mfiledownload.com	nil
neswangy.net	nil
wustl.edu	nil
sdna.gr	nil
tvguide.co.uk	nil
yobt.com	nil
ebuyer.com	nil
sears.ca	nil
matomy.com	nil
jobs.net	nil
gumroad.com	nil
rmdown.com	nil
allyou.com	nil
hmetro.com.my	nil
hopy.com	nil
wisestamp.com	nil
showoff.com.cn	nil
kinoman.tv	nil
thebump.com	nil
tielabs.com	nil
kbstar.com	nil
overclockers.ru	nil
payzippy.com	nil
linio.cl	nil
networksolutionsemail.com	nil
studenti.it	nil
thenounproject.com	nil
snapchat.com	nil
powerreviews.com	nil
x3xtube.com	nil
jbhifi.com.au	nil
sportsnet.ca	nil
work.ua	none	self
tigerair.com	none	agari
bolsademulher.com	nil
domofond.ru	nil
gq.com.tw	nil
flavorwire.com	invalid
123sdfsdfsdfsd.ru	nil
promiflash.de	reject	
thenewstribe.com	nil
listindiario.com	nil
feedjit.com	nil
sport.ro	nil
droid-life.com	nil
haitaobei.com	nil
wayport.net	nil
sportsmansguide.com	nil
useclix.com	none	dmarcian
dailyhiit.com	nil
medisite.fr	nil
themify.me	nil
subway.com	nil
9news.com	nil
trk4.com	nil
namejet.com	nil
wisegeek.com	nil
ecitic.com	nil
lobsterxxx.com	nil
mydigit.cn	nil
minecraftskins.com	nil
pornpros.com	nil
ucl.ac.uk	nil
cgg.gov.in	nil
canalporno.com	nil
docker.com	nil
torrentz.com	nil
skapiec.pl	nil
undergradsuccess.com	nil
hrs.de	nil
evz.ro	nil
gioco.it	nil
lyricsmode.com	nil
dlink.com	nil
funtrivia.com	nil
htmlbook.ru	nil
football365.com	nil
empik.com	nil
vtb24.ru	nil
netcentrum.cz	nil
twenga.fr	nil
ecwid.com	nil
t66y.com	nil
airbnb.it	reject	self
standaard.be	nil
playerpage207.info	nil
gmu.edu	nil
safercar.gov	nil
crash.net	nil
rockauto.com	nil
hanes.com	nil
cafef.vn	nil
betanews.com	nil
yify-movie.com	nil
imgfarm.com	nil
mtagmonetizationc.com	nil
nbg.gr	nil
sagepay.com	nil
ono.es	nil
avianca.com	nil
babyhome.com.tw	nil
16personalities.com	nil
jkpj.com	nil
imgsrc.ru	nil
citizensbank.com	nil
get2ch.net	nil
ajel.sa	nil
parimatchru.com	nil
elmstba.com	nil
destructoid.com	nil
ikyu.com	nil
befunky.com	nil
legalzoom.com	nil
omgfacts.com	nil
naosalvo.com.br	nil
purewow.com	nil
graphicburger.com	nil
teletalk.com.bd	nil
jne.co.id	nil
howtotipz.com	nil
riotgames.com	nil
day.az	nil
vivareal.com.br	nil
myp2pch.net	nil
e-shop.gr	nil
erogazoufactory.com	nil
serialu.net	nil
postnl.nl	none	self
a1on.mk	nil
freepdfconvert.com	nil
your-server.de	nil
sparkfun.com	nil
2cpu.co.kr	nil
seccionamarilla.com.mx	nil
men.com	nil
anakbnet.com	nil
mopo.de	nil
cjdby.net	nil
tap4joy.com	nil
ilsussidiario.net	nil
thenote.com.tw	nil
tarad.com	nil
xamarin.com	nil
summitracing.com	nil
ficbook.net	nil
twitterfeed.com	nil
2cto.com	nil
lolinez.com	nil
abc.com.py	nil
lufax.com	nil
alweeam.com.sa	nil
sinemalar.com	nil
3m.com	nil
uw.edu	nil
qvc.de	nil
graphicstock.com	nil
zeri.info	nil
meh.com	nil
tehparadox.com	nil
redbookmag.com	nil
pearl.de	nil
brothersoft.com	nil
17life.com	nil
italia-film.org	nil
jpc.com	nil
volagratis.com	nil
la-mirada.org	nil
thetoptens.com	nil
dudecomedy.com	nil
bunnings.com.au	nil
fnac.es	nil
arukereso.hu	nil
erogamescape.dyndns.org	nil
javfree.me	nil
nd.edu	nil
indiana.edu	nil
memegenerator.net	nil
dailysteals.com	nil
arcgis.com	nil
nissanusa.com	nil
95516.com	nil
oem.com.mx	nil
janebi.ir	nil
google.ht	none	self:google
postfinance.ch	nil
lambingan.to	nil
leroymerlin.es	nil
koreaboo.com	nil
swedbank.lt	nil
mediafree.co	nil
designmodo.com	nil
flydubai.com	nil
yelp.de	none	self
bestday.com.mx	nil
mris.com	nil
torontosun.com	nil
ofreegames.com	nil
hipmunk.com	nil
tanteifile.com	nil
dailyo.in	nil
tubexclips.com	nil
lenovo.com.cn	nil
buzzle.com	nil
eroticbeauties.net	nil
appround52.com	nil
571xz.com	nil
thescene.com	nil
forumophilia.com	nil
mycanal.fr	nil
sportdog.gr	nil
dailyliked.net	nil
motherearthnews.com	invalid
ti-reviews.com	nil
minus.com	nil
pricecheck.co.za	nil
europe1.fr	nil
netmums.com	nil
dressupgames.com	nil
jagonews24.com	nil
adpost.com	nil
gls-group.eu	nil
memrise.com	nil
mo.gov	nil
cromaretail.com	nil
appround72.com	nil
aebn.net	nil
inkthemes.com	nil
gamgos.ae	nil
learntotradethemarket.com	nil
libaclub.com	nil
wsodownloads.info	nil
convertonlinefree.com	nil
travian.com	nil
elcats.ru	nil
bnl.it	nil
jsonline.com	nil
nowdownload.ch	nil
southmoney.com	nil
preloved.co.uk	nil
playerpage200.info	nil
ebizmba.com	nil
cctv.com	nil
popcap.com	nil
setn.com	nil
html.it	nil
spin.ph	nil
systweak.com	nil
hitleap.com	nil
ethnos.gr	nil
kinja-img.com	nil
akhbarona.com	nil
qudrat.com.pk	nil
femina.hu	nil
milfmovs.com	nil
mmajunkie.com	nil
weibo.cn	nil
krisha.kz	nil
didigames.com	nil
worldoftanks.com	nil
sunat.gob.pe	nil
33lc.com	nil
medyanetads.com	nil
opodo.de	nil
mofos.com	nil
liverpoolecho.co.uk	nil
dogpile.com	nil
www.gov.cn	nil
365cgw.com	nil
vemale.com	nil
megaindex.ru	nil
colehaan.com	nil
tubeboat.com	nil
ryusoku.com	nil
healthtap.com	nil
captainquizz.com	nil
jsbin.com	invalid
9111.ru	none	self
siteprice.org	nil
ysear.ch	nil
sonicch.com	nil
mkpri3fasq4cn5.ru	nil
acronymfinder.com	nil
forbes.pl	nil
seriesbang.net	nil
navercorp.com	nil
oniyomediary.com	nil
toryburch.com	nil
thetoc.gr	nil
tufts.edu	nil
careerride.com	nil
movietube.cc	nil
unl.edu	nil
101.ru	nil
noor.moe.sa	nil
webrankstats.com	nil
gewara.com	nil
pearsonvue.com	nil
instapage.com	nil
24option.com	nil
1pondo.tv	nil
52pojie.cn	nil
musicplayon.com	nil
oscaro.com	nil
kanagawa.jp	nil
lotto.pl	nil
renfe.es	nil
bankinter.com	nil
admngronline.com	nil
lucidchart.com	nil
gamespark.jp	nil
companycheck.co.uk	nil
csgostash.com	nil
dicelacancion.com	nil
mediadog.ru	nil
k12.wi.us	nil
seratnews.ir	nil
cebupacificair.com	nil
sportsbet.com.au	nil
uolhost.com.br	nil
delhivery.com	nil
tiankong.com	nil
pornodingue.com	nil
burberry.com	nil
tiancity.com	nil
pogdesign.co.uk	nil
whattoexpect.com	nil
felissimo.co.jp	nil
polki.pl	nil
tvboxnow.com	nil
jjgirls.com	nil
soft32.com	nil
punyu.com	nil
j-lyric.net	nil
scambioetico.org	nil
gametracker.com	nil
carthrottle.com	nil
infor.pl	nil
insight.co.kr	nil
safedownloadsrus130.com	nil
mckinsey.com	nil
star.com.tr	nil
navi-gaming.com	nil
jeep.com	nil
sun-sentinel.com	nil
nairabet.com	nil
setlist.fm	invalid
trafficbroker.com	nil
vodafone.com.tr	nil
win-legko.info	nil
pinkrod.com	nil
laterooms.com	nil
detroitnews.com	nil
second.by	nil
apsrtconline.in	nil
softwaresupermyuk.in	nil
pixgood.com	nil
ertya.com	invalid
internet.org	none	agari
dreammovies.com	nil
zi-m.com	nil
beenverified.com	nil
lobstertube.com	nil
terra.com.mx	nil
portalcorreio.uol.com.br	nil
emc.com	nil
appround32.com	nil
t-mobile.de	nil
simplyrecipes.com	nil
jawabkom.com	nil
jameda.de	invalid
aftership.com	nil
gunosy.com	nil
gofuckbiz.com	nil
f5haber.com	nil
puls24.mk	nil
adbkm.com	nil
kajabi.com	nil
domain.com	nil
sej.co.jp	nil
waseet.net	invalid
cricfree.sx	nil
pinkvilla.com	nil
t3n.de	nil
cio.com	nil
searchpeack.com	nil
12tomatoes.com	nil
flets.com	nil
animoto.com	nil
pornpics.com	nil
tubegora.com	nil
start.me	nil
phncdn.com	nil
kink.com	none	self
beeradvocate.com	nil
aintitcool.com	nil
ucr.edu	nil
coral.co.uk	nil
ddl-warez.in	nil
jackthreads.com	none	unknown:dmarc@thrillist.com
monster.co.uk	nil
worldoftanks.asia	nil
pku.edu.cn	nil
lazada.sg	nil
thepointsguy.com	nil
bookbub.com	nil
appround62.com	nil
bikebros.co.jp	nil
faststore.org	nil
asstr.org	nil
ebay.com.sg	none	agari,returnpath
kau.edu.sa	nil
zjol.com.cn	nil
pdapi.com	nil
logpo.jp	nil
readmanga.me	nil
starfall.com	nil
nettiauto.com	nil
c-ij.com	nil
sayyac.com	nil
craigslist.co.in	none	dmarcian
librus.pl	nil
akmall.com	nil
24livenewspaper.com	nil
standardmedia.co.ke	nil
einthusan.com	nil
mobiletest.me	nil
3a6aayer.com	nil
smusic.ir	nil
tinyez.tv	nil
teamcoco.com	nil
yougov.com	nil
wwtdd.com	nil
fabric.com	none	agari,dmarcian
punjabkesari.in	nil
siol.net	nil
rapmls.com	none	unknown:postmaster@rapattoni.com
my.tv.sohu.com/user/video	nil
cdw.com	nil
cpagrip.com	nil
mojomarketplace.com	nil
legifrance.gouv.fr	nil
poczta-polska.pl	nil
stoiximan.gr	nil
iflashbuy.com	nil
abritel.fr	reject	agari,haspf
imtranslator.net	nil
livelib.ru	nil
crocs.com	nil
kizlarsoruyor.com	quarantine	postmarkapp,dmarcian
ndsplitter.com	nil
wizaz.pl	nil
digitalmarketer.com	none	unknown:emddmarc@gmail.com
ashford.com	nil
scbeasy.com	nil
kisscartoon.me	nil
smartpassiveincome.com	nil
twcc.com	nil
focus-asia.com	nil
elblog.com	nil
win007.com	nil
pesni.fm	nil
autoscout24.ch	nil
phonegap.com	nil
helpster.de	nil
amazon.com.au	nil
tushkan.net	nil
nikkan-spa.jp	nil
bloggersideas.com	nil
salamnews.org	nil
bankpasargad.com	nil
noip.com	invalid
grandiose-money.info	nil
imgbuddy.com	nil
appround42.com	nil
clicktripz.com	nil
eurostreaming.tv	nil
potterybarnkids.com	nil
instyle.com	nil
crossfit.com	nil
voyeurweb.com	nil
grandbux.net	nil
cybozulive.com	nil
extranetinvestment.com	nil
newbillion.cn	nil
okanime.com	nil
dreamwidth.org	nil
airarabia.com	quarantine	self
momtaznews.com	nil
ns.nl	nil
zhifang.com	nil
cv-library.co.uk	nil
mydirtyhobby.com	nil
dota2.ru	nil
akismet.com	quarantine	dmarcian
livecareer.com	invalid
gleam.io	nil
zoom.us	nil
asiatech.ir	nil
titan24.com	nil
search-results.com	nil
uga.edu	nil
customs.go.kr	nil
ocbc.com	nil
fresherslive.com	nil
bostonherald.com	nil
crazyegg.com	nil
crx7601.com	nil
dyn.com	none	self,dmarcian,agari,postmarkapp
1stwebdesigner.com	nil
gsn.com	nil
hitbox.tv	nil
kasi-time.com	nil
eightforums.com	nil
cfi.cn	nil
akinator.com	nil
bd24live.com	nil
xm.com	nil
luxuretv.com	nil
mes-meilleurs-films.fr	nil
fanatics.com	nil
ce4arab.com	nil
chmail.ir	nil
belfius.be	none	self
eltrecetv.com.ar	nil
notonthehighstreet.com	nil
lalibre.be	nil
soccer.ru	nil
juesheng.com	nil
vi.nl	nil
pathofexile.com	nil
italki.com	nil
guju.com.cn	nil
methode-finance.com	nil
maisonsdumonde.com	nil
rumbo.es	nil
edreams.es	nil
balatarin.com	nil
thenewslens.com	nil
decathlon.es	nil
rbc.com	nil
subaonet.com	none	self
imbc.com	nil
colourlovers.com	nil
gbjobs.com	nil
zdnet.co.kr	nil
esam.ir	nil
eq28.cn	nil
9lwan.com	nil
bsi.ir	nil
fullvehdfilmizle.com	nil
whiteskyservices.com	nil
ero-kawa.com	nil
khamenei.ir	none	self
theme.co	nil
seb.se	nil
tibet.cn	nil
parsiblog.com	nil
pornocarioca.com	nil
chewy.com	nil
bancomer.com.mx	nil
icarros.com.br	nil
chobirich.com	nil
fok.nl	nil
thisiscolossal.com	nil
justfab.com	none	agari
sendgrid.com	quarantine	agari,self
rysnoticias.com	nil
svtplay.se	nil
allwhoop.com	nil
kalaydo.de	nil
zacks.com	nil
similarsites.com	nil
nta.go.jp	nil
crsky.com	nil
fff.fr	nil
afamily.vn	nil
stihi.ru	nil
sld.cu	nil
bloombergview.com	nil
footyroom.com	nil
tudocelular.com	nil
gossip1.net	nil
gelbeseiten.de	nil
hktdc.com	nil
cnool.net	nil
oup.com	nil
seriesubthai.com	nil
residentadvisor.net	nil
adsmena.com	nil
jizhangla.com	nil
abbreviations.com	nil
perfora.net	nil
kerbalspaceprogram.com	nil
btdigg.org	nil
thegeekstuff.com	nil
twc.com	nil
99inf.com	nil
jbzd.pl	nil
makezine.com	nil
autoanything.com	nil
fotka.pl	nil
folha.com.br	nil
gacetainformativa.com	nil
tvn.pl	nil
eshahed.com	nil
glamsham.com	nil
lidovky.cz	nil
edreams.it	nil
gamepressure.com	nil
chanel.com	nil
thebot.net	nil
95081.com	nil
unblocksit.es	nil
kfu.edu.sa	nil
ctbcbank.com	nil
bestchange.ru	nil
ojogo.pt	nil
oclc.org	nil
incisozluk.com.tr	invalid
9miao.com	nil
allin1convert.com	nil
247wallst.com	invalid
denik.cz	nil
e-autopay.com	nil
oeker.net	nil
tjournal.ru	nil
dlisted.com	nil
spieletipps.de	nil
dl-xvideos.com	nil
denizhaber.com.tr	nil
habitaclia.com	none	self
o2tvseries.com	nil
r18.com	nil
bolha.com	nil
updatestar.com	nil
wpkg.org	none	self
webstatsdomain.org	nil
hirunews.lk	nil
seriesdanko.com	nil
tommy.com	nil
instapaper.com	nil
journaldemontreal.com	nil
minnano-av.com	nil
ittefaq.com.bd	nil
annasdiary.com	nil
davidsbridal.com	nil
3lian.com	nil
digiato.com	nil
trafficonlingetstorage.in	nil
mbusa.com	nil
click108.com.tw	nil
ahangestan.in	nil
proquest.com	nil
yellowpages.com.au	nil
itp.ne.jp	nil
extcontent.com	nil
barbie.com	nil
sexxx.cc	nil
deobp.com	nil
turbosquid.com	nil
homeplus.co.kr	nil
longdo.com	nil
straighttalk.com	nil
entrance-exam.net	nil
cosp.jp	nil
umass.edu	nil
addurl.nu	nil
veikkaus.fi	nil
real.com	nil
pulptastic.com	nil
kelkoo.com	nil
biggerpockets.com	nil
baharnews.ir	nil
meilishuo.com	nil
tlife.gr	nil
expert.ru	nil
pbebank.com	nil
namepros.com	reject	self
thespiritscience.net	nil
targobank.de	nil
uploadbaz.com	nil
shanghaidz.com	nil
xmarks.com	nil
a2hosting.com	nil
bcash.com.br	invalid
ytpak.com	nil
typekit.com	nil
telugumatrimony.com	nil
daft.ie	nil
elnuevodiario.com.ni	nil
allure.com	nil
golfchannel.com	nil
planalto.gov.br	nil
todayifoundout.com	nil
linksys.com	nil
anses.gob.ar	nil
aladin.co.kr	nil
torrentgogo.net	nil
warnerbros.com	nil
bmj.com	nil
bien.hu	nil
empireonline.com	nil
specialized.com	nil
soccersuck.in.th	nil
op.fi	nil
kulichki.net	nil
alayam24.com	nil
twistedsifter.com	invalid
coqnu.com	nil
manageflitter.com	nil
unisa.ac.za	nil
halfords.com	nil
wittytv.it	nil
urbanladder.com	nil
wetpaint.com	nil
digid.nl	nil
stgeorge.com.au	none	returnpath
af.mil	nil
quantcast.com	nil
packtpub.com	nil
ejemplode.com	nil
ickey.cn	nil
mlssoccer.com	nil
bet9ja.com	nil
trovit.com.mx	nil
bidsystem.com	nil
readwrite.com	invalid
groupon-content.net	nil
coolrom.com	nil
kinguin.net	nil
avjavjav.com	nil
indgovtjobs.in	nil
xiazaiba.com	nil
indulgy.com	nil
cloudvpsfiles.com	nil
pikolive.com	nil
business.gov.au	nil
pakwheels.com	invalid
u-tokyo.ac.jp	nil
americanapparel.net	nil
gtarcade.com	nil
wallst.com	nil
bootply.com	nil
autosport.com	nil
freelogoservices.com	nil
vivo.sx	nil
haaretz.com	nil
vodafone.es	nil
centrum.sk	nil
opinionlab.com	nil
flyasiana.com	nil
dealabs.com	nil
doostiha.ir	nil
planningcenteronline.com	invalid
idealist.org	nil
sina.cn	nil
xtec.cat	nil
metal-archives.com	nil
gamejolt.com	nil
ultrasocl.com	nil
superbahis229.com	nil
onmeda.de	nil
wat.tv	nil
plos.org	nil
caltech.edu	nil
utsandiego.com	nil
paulaschoice.com	invalid
nhentai.net	nil
fh21.com.cn	nil
dingoads.info	nil
upsconline.nic.in	nil
supercell.net	nil
0101.co.jp	nil
zerochan.net	nil
ebay.pl	none	agari,returnpath
hindawi.com	none	self
seniat.gob.ve	nil
voluum.com	invalid
bauhaus.info	nil
bloggang.com	nil
wp.tv	invalid
maxbounty.com	nil
indeed.com.br	nil
bjs.com	nil
kinobar.net	nil
fakenamegenerator.com	nil
aclst.com	nil
adsl.free.fr	nil
indusind.com	nil
savemoneyindia.com	nil
ziraatbank.com.tr	nil
politiken.dk	nil
animestigma.com	nil
georgetown.edu	nil
studentloans.gov	none	unknown:dmarc@ed.gov
chipotle.com	nil
bitshare.com	nil
roksa.pl	nil
benchmarkemail.com	nil
banamex.com	reject	agari,self
infopanel.jp	nil
awesomequotes4u.com	nil
theporndude.com	nil
streamay.com	nil
stacksocial.com	nil
mazda.co.jp	invalid
syracuse.com	nil
btc-e.com	nil
pge.com	none	agari,self
panoramastock.com	nil
piazza.com	nil
livesurf.ru	nil
gigaom.com	nil
expat-blog.com	nil
eremnews.com	nil
postjung.com	nil
thecarconnection.com	nil
lulus.com	nil
webrankinfo.com	nil
racing-games.com	nil
lativ.com.tw	nil
gateway.gov.uk	nil
brooonzyah.net	nil
auto-motor-und-sport.de	nil
sextubeset.com	nil
godlikeproductions.com	nil
profitcentr.com	nil
northeated.com	nil
softonic.fr	nil
siteliner.com	nil
adsflyhigh.net	nil
brandsoftheworld.com	nil
bobibanking.com	nil
leadsfinders.com	nil
bpiexpressonline.com	nil
nsdl.com	nil
buysellads.com	none	postmarkapp
eva.vn	nil
maturemoms.tv	nil
olx.hu	nil
tutorialrepublic.com	nil
megamozg.ru	nil
sndcdn.com	nil
idownloadblog.com	nil
clipd.com	nil
bikeradar.com	nil
chance.com	nil
co-operativebank.co.uk	reject	agari,netcraft
free-power-point-templates.com	nil
clip2net.com	nil
racingpost.com	nil
mysku.ru	nil
gigabyte.com	nil
whosay.com	nil
codeigniter.com	nil
sunbet2222.com	nil
zalando.es	nil
17iw.com	nil
rabota.ua	nil
flibusta.net	nil
home.ne.jp	nil
ilmattino.it	nil
vse.kz	nil
hepsibahis101.com	nil
paisdelosjuegos.com.ar	nil
wifi.id	nil
eenadupratibha.net	nil
startpagina.nl	nil
uta-net.com	nil
zedge.net	nil
lastfm.ru	nil
haruka-yumenoato.net	nil
formget.com	nil
derwaza.cc	nil
fabletics.com	none	agari
beachbody.com	nil
merchantcircle.com	nil
nsportal.ru	nil
esmplus.com	nil
movierulz.com	nil
jc001.cn	nil
yumpu.com	nil
kaufda.de	nil
healthunlocked.com	nil
3dcartstores.com	nil
thenest.com	nil
hotscripts.com	nil
6alabat.com	nil
amaebi.net	nil
clickme.net	nil
1ting.com	nil
vandal.net	nil
sikayetvar.com	nil
dotnetperls.com	nil
lifecard.co.jp	nil
cduniverse.com	nil
vodly.to	nil
juggly.cn	nil
fusion.net	invalid
wheretofinder.com	nil
ganeshaspeaks.com	nil
kir.jp	nil
n159adserv.com	nil
ewn.co.za	nil
teamsnap.com	nil
dygang.com	nil
playboyplus.com	nil
natura.net	nil
jd.hk	nil
meritnation.com	nil
51netu.com.cn	nil
cbi.ir	nil
tportal.hr	nil
digitalriver.com	nil
ecmsglobal.com	none	self:netease
ku.edu	nil
jianshu.com	nil
mybloggertricks.com	nil
rozklad-pkp.pl	nil
theaa.com	nil
bricodepot.fr	nil
marketgid.ru	nil
swefilmer.com	nil
hir.ma	invalid
ashleymadison.co.kr	none	unknown:dmarc_dump@ashleymadison.com
elle.com.tw	nil
pagina12.com.ar	nil
dailyrecord.co.uk	nil
gizbot.com	nil
encar.com	nil
ftc.gov	nil
youxixiazai.org	nil
patagonia.com	nil
bravenet.com	nil
fux.com	nil
pinoynetwork.to	nil
windstream.net	nil
officeworks.com.au	nil
banksifsccode.com	nil
k7x.com	nil
redcoon.de	nil
open.ac.uk	nil
webssearcher.com	nil
unionbankonline.co.in	nil
uned.es		
buenosaires.gob.ar	nil
k12.va.us	nil
icdrama.se	nil
doit.com.cn	nil
subaru.jp	nil
menswearhouse.com	nil
gameblog.fr	nil
technologyreview.com	nil
whitepins.com	nil
zwinky.com	nil
frontier.com	nil
toptenhen.com	nil
bongda.com.vn	nil
delhi.gov.in	nil
utah.gov	nil
filmehd.net	nil
emirates247.com	nil
belluna.jp	nil
digicame-info.com	nil
meneame.net	nil
windeln.de	nil
extremetracking.com	nil
tokyotosho.info	nil
life.hu	nil
couriermail.com.au	nil
miss-no1.com	nil
linkpad.ru	nil
india.gov.in	nil
uj.com.tw	nil
petmd.com	nil
okazii.ro	nil
tp-link.com.cn	nil
wearehairy.com	nil
new-rutor.org	nil
retty.me	nil
fnac.pt	nil
i2ya.com	nil
fora.pl	nil
themalaymailonline.com	nil
foreignpolicy.com	invalid
nacion.com	nil
khaleejtimes.com	nil
rdsa2011.com	nil
hkej.com	nil
sjmads.com	nil
doktorsitesi.com	nil
public-api.wordpress.com	nil
webcg.net	nil
tescobank.com	nil
moneta.co.kr	nil
qq5.com	nil
telelistas.net	nil
thiruttuvcd.biz	nil
wccftech.com	nil
bankaustria.at	nil
jianso.com	nil
taker.im	invalid
wellnessmama.com	nil
beyazperde.com	nil
costcotravel.com	nil
ninjakiwi.com	nil
icm.edu.pl	nil
apkmirror.com	nil
asianwiki.com	nil
radaris.com	nil
gandi.net	nil
techtunes.com.bd	nil
supercheats.com	nil
getgoodlinks.ru	invalid
1ru.tv	nil
anxin.com	none	self:netease
nzw.cn	nil
idigitaltimes.com	nil
audiopoisk.com	nil
expediapartnercentral.com	nil
firefox.com.cn	nil
tatts.com	nil
pb.com	nil
zfh.cn	nil
cart.tmall.com	nil
espn.com.mx	nil
listal.com	nil
cutezee.com	nil
tekstowo.pl	nil
sportsmole.co.uk	nil
studymode.com	reject	self
clipartpanda.com	nil
21cineplex.com	nil
tema.livejournal.com	nil
millenniumbcp.pt	nil
apontador.com.br	nil
webmasters.ru	nil
getuploader.com	nil
freelancer.in	nil
flashkhor.com	nil
trialpay.com	nil
720pizle.com	nil
win8daohang.com	nil
daniweb.com	nil
publitas.com	nil
qianxs.com	nil
express-scripts.com	nil
amalgama-lab.com	nil
getitfree.us	reject	self
unwire.hk	nil
notebookreview.com	nil
game2.com.cn	nil
via.com	nil
producteev.com	nil
trackvoluum.com	nil
newscientist.com	none	agari
ventivmedia.com	nil
boerse.to	nil
members.webs.com	nil
kasikornbank.com	nil
letsfinder.com	nil
lasexta.com	nil
sktelecom.com	nil
masaladesi.com	nil
seocentro.com	nil
swirlsearch.com	nil
howtoforge.com	nil
volusion.com	nil
skatteverket.se	reject	self
gravity.com	nil
afr.com	nil
alquds.co.uk	nil
dmi.dk	nil
watchuseek.com	nil
onlineaccess1.com	nil
journaldugeek.com	nil
skoob.com.br	nil
sundayworld.com	nil
erotube.org	nil
hnzxyy.com	nil
litv.tv	nil
malavida.com	invalid
qdmm.com	nil
torrinomedica.it	nil
donya-e-eqtesad.com	nil
mixpanel.com	nil
compucalitv.com	nil
evozi.com	nil
webcamtoy.com	nil
alltop.com	invalid
thedailystar.net	nil
jibjab.com	nil
streema.com	nil
pastsearcher.com	nil
mobypicture.com	nil
laweekly.com	nil
iridiumsearch.com	nil
nsw.edu.au	nil
babosas.com	invalid
purelyfootball.com	nil
beppegrillo.it	nil
klix.ba	nil
artstation.com	nil
pcworld.co.uk	nil
open2ch.net	nil
olacabs.com	nil
minglebox.com	none	postmarkapp
anastasiadate.com	nil
3dlat.net	nil
pravda.ru	nil
canada411.ca	nil
fapdu.com	nil
pronto.com	nil
xjtour.com	nil
tataindicom.com	nil
dng65.com	nil
twilio.com	nil
elephanttube.com	nil
cc98.org	nil
liquidweb.com	nil
adpageviews.com	nil
gtaforums.com	nil
moportals.com	nil
searchcave.com	nil
souism.com	nil
youngliving.us	nil
booksky.org	nil
keepa.com	reject	self
elfinanciero.com.mx	nil
parenting.com	nil
pokerstrategy.com	nil
minfin.com.ua	invalid
dunya.com.pk	nil
airbnb.co.uk	reject	self
cinejosh.com	nil
pocket-lint.com	nil
bitnami.com	nil
freedigitalphotos.net	nil
krakow.pl	nil
hdxxx.me	nil
50onred.com	nil
elecom.co.jp	nil
chinaacc.com	nil
030buy.com	nil
downloadder.ir	nil
searchscroll.com	nil
friendscout24.de	nil
d-h.st	nil
yac.mx	nil
downloadming.sx	nil
myprotein.com	nil
paysafecard.com	none	returnpath
xo.gr	nil
vfsglobal.com	nil
pzy.be	nil
forumotion.com	nil
roosterteeth.com	nil
symbols-n-emoticons.com	nil
ncl.com	nil
bod.com.ve	nil
meetdoctor.com	nil
dinos.co.jp	nil
lxwxw.com	nil
thejournal.ie	nil
distancesfrom.com	nil
seopult.ru	nil
up-00.com	nil
moodle.org	quarantine	
lycos.com	nil
youwatch.org	nil
livehotty.com	none	unknown:dmarc-reports@flyingcroc.net,unknown:dmarc-abuse-reports@flyingcroc.net
startlap.com	nil
iplaysoft.com	nil
cib.com.cn	nil
vivastreet.co.in	nil
dospy.com	nil
finances.gouv.fr	nil
brightcove.com	nil
putlocker.com	nil
pokemon.com	nil
freelance.ru	nil
anonhq.com	nil
ask-tb.com	nil
yasdl.com	nil
searchquirk.com	nil
research.net	reject	returnpath
cjn.cn	nil
8080.net	nil
zonealarm.com	nil
luminpdf.com	nil
anser.ne.jp	nil
elamwal.com	nil
okbuy.com	nil
ingdirect.it	nil
buybuybaby.com	nil
cubadebate.cu	nil
robertsspaceindustries.com	nil
luisaviaroma.com	invalid
princess.com	nil
kankokunohannou.org	nil
plaisio.gr	nil
crowdflower.com	nil
tubelibre.com	nil
eklablog.com	invalid
worldtruth.tv	nil
a1.net	nil
tehran.ir	nil
yengo.com	nil
downloadcoast.com	nil
allfreecrochet.com	nil
olx.com.pe	nil
color-hex.com	nil
oculus.com	nil
ifanr.com	nil
twitlonger.com	nil
justgiving.com	nil
kpmg.com	nil
anz.co.nz	quarantine	self
chosunonline.com	nil
daliulian.org	nil
55188.com	nil
bnc.ca	nil
thenational.ae	nil
25pp.com	nil
findersocket.com	nil
numbeo.com	nil
drsfostersmith.com	nil
hello-pet.com	nil
tiffany.com	nil
irmp3.ir	nil
visitkorea.or.kr	nil
wtoip.com	nil
creativelive.com	nil
warframe.com	nil
fatcow.com	nil
onlymyhealth.com	nil
cuelinks.com	nil
imslp.org	nil
yellowpages.co.in	nil
ktone.cn	nil
allposters.com	nil
carloanlender.com	nil
colonelcassad.livejournal.com	nil
redcross.org	nil
racked.com	nil
forrent.com	nil
soccervista.com	nil
flash-game.cc	nil
shareaholic.com	nil
pausecafein.fr	nil
trkur.com	nil
narkive.com	invalid
okpay.com	nil
fotolog.net	nil
stuff.tv	nil
globalpost.com	nil
1afcfcb2c.ninja	nil
sm3na.com	nil
sarkariexaam.com	nil
cn2che.com	nil
leg.br	nil
acesso.gov.pt	nil
maxtv.cn	nil
punjab.gov.pk	nil
athenahealth.com	nil
dl-zip.com	nil
keng94.com	nil
kyofun.com	nil
kenrockwell.com	nil
deyi.com	nil
maryland.gov	nil
myhermes.de	nil
araskargo.com.tr	nil
coubei.com	nil
ctrlq.org	nil
zaq.ne.jp	nil
rtvslo.si	nil
musicnotes.com	nil
geo-online.co.jp	nil
torrentino.net	nil
hypestat.com	nil
elciudadano.cl	nil
caclubindia.com	invalid
starwars.com	nil
contactcars.com	nil
odin.com	none	
nemzetisport.hu	nil
sakura.ad.jp	nil
cesumar.br	nil
sfacg.com	nil
aliway.com	nil
appthemes.com	nil
taoguba.com.cn	nil
fermasosedi.ru	nil
91.com	nil
designboom.com	nil
tn.gov.in	nil
appsflyer.com	nil
net-combo-ja.com	nil
all-nationz.com	nil
webassign.net	nil
9966.org	nil
unionbank.com	none	agari,returnpath
puma.com	nil
sunfrogshirts.com	nil
eventbrite.co.uk	nil
erji.net	nil
myzuka.org	nil
iafd.com	nil
bgr.in	nil
kepu.net.cn	nil
xxxpornotuber.com	nil
couchtuner.me	nil
99.com	nil
0755car.com	nil
trafficsecure.net	nil
thaqafnafsak.com	nil
iihfworlds2015.com	nil
llnwd.net	nil
kingstone.com.tw	nil
rurubu.travel	nil
optus.com.au	nil
wired.it	nil
post-gazette.com	nil
newspickup.com	nil
adverts.ie	nil
englishtown.com	nil
ti-da.net	invalid
raftaar.in	nil
webmasterworld.com	nil
novosti.rs	nil
covers.com	nil
ct10000.com	nil
qoo10.co.id	nil
thesportbible.com	nil
greenhouse.io	invalid
athemes.com	nil
zoub.cn	nil
espn.co.uk	nil
dv37.com	nil
elnorte.com	nil
padmapper.com	nil
telam.com.ar	nil
priberam.pt	nil
zennioptical.com	nil
markets.com	nil
doda.jp	nil
metrprice.ru	nil
alison.com	nil
gooyaabitemplates.com	nil
gizmodo.uol.com.br	nil
xxxtubedot.com	nil
prizegrab.com	nil
thefreethoughtproject.com	nil
senasofiaplus.edu.co	nil
kmcert.com	nil
eniro.se	nil
albayan.ae	nil
mindtools.com	nil
saharareporters.com	nil
hardforum.com	nil
box.net	reject	agari
matthewwoodward.co.uk	nil
uverse.com	nil
siren24.com	nil
buffalo.edu	nil
sytes.net	nil
ishuhui.com	nil
berries.com	nil
sharekhan.com	nil
alltechbuzz.net	nil
cocoachina.com	nil
tlcthai.com	nil
womansday.com	nil
rainiertamayo.com	nil
vz.lt	nil
geizhals.de	nil
primagames.com	nil
google-analytics.com	reject	self:google
tripadvisor.com.mx	nil
sucursalelectronica.com	nil
arynews.tv	nil
fab.com	nil
hitfile.net	nil
gwu.edu	nil
jobbank.gc.ca	nil
moonbit.co.in	nil
truelife.com	nil
tvgids.nl	nil
mail2web.com	nil
prchecker.info	nil
evine.com	nil
gamekult.com	nil
um.ac.ir	quarantine	
ubibanca.com	nil
ccma.cat	nil
escapadarural.com	nil
netaatoz.jp	nil
startsiden.no	nil
maultalk.com	nil
littleone.ru	nil
islamqa.info	nil
pcmfw.com	invalid
state.ny.us	nil
spareroom.co.uk	nil
tiket.com	nil
rtl2.de	nil
hepsibahis100.com	nil
tvc.ru	nil
leadoor.com	nil
aktifhaber.com	nil
okcaller.com	nil
airindia.in	nil
atrapalo.com	nil
bloggertipstricks.com	nil
diablo3.com.cn	nil
dunzo.net	nil
16mb.com	nil
sokmil.com	nil
neonan.com	nil
urasunday.com	nil
rallydev.com	nil
uic.edu	nil
dynadot.com	nil
homebank.kz	nil
rochester.edu	nil
eddiebauer.com	nil
sunrise.am	nil
motika.com.mk	nil
house.gov	none	self,returnpath
swedbank.lv	nil
spine-health.com	nil
poetryfoundation.org	nil
awesomescreenshot.com	nil
sexhubhd.com	nil
nbcnewyork.com	nil
chelseafc.com	none	returnpath
vanityfair.it	nil
match.net.tw	nil
tufeed.com	nil
torproject.org	nil
lifemedia.jp	nil
elbilad.net	nil
thehun.net	nil
daoxila.com	nil
sc.gov.br	nil
klumba.com	nil
tarot.com		
haberkita.com	nil
thebrowsergame.com	nil
followmyhealth.com	nil
sadistic.pl	nil
careerlink.vn	nil
rusplt.ru	nil
affiliatewindow.com	nil
monow.jp	nil
lastcall.com	nil
motorsport.com	nil
almanac.com	nil
sabavision.com	nil
monster.de	nil
mygreatlakes.org	nil
gulftalent.com	nil
sport24.co.za	nil
gololy.com	nil
javjunkies.com	nil
imperialsearch.com	nil
tvmovie.de	nil
uniqlo.tmall.com	nil
livrariacultura.com.br	nil
vancouversun.com	nil
ipopup.ir	nil
thenewporn.com	nil
h-douga.net	nil
zattoo.com	nil
affiliatetechnology.com	nil
airbnb.de	reject	self
dti.ne.jp	none	
mavitv.com.tr	nil
rafflecopter.com	nil
elcolombiano.com	nil
speckyboy.com	nil
jmys168.com	nil
vertex42.com	nil
abcmouse.com	nil
toopix.biz	nil
nrw.de	nil
goldpornfilms.com	nil
medyaege.com	nil
softonic.com.br	nil
tim.com.br	nil
zameen.com	nil
11467.com	nil
pisos.com	nil
finansbank.com.tr	nil
e-leclerc.com	nil
gulesider.no	nil
ewg.org	nil
koutipandoras.gr	nil
plus.es	nil
fundorado.de	nil
sba.gov	nil
spaces.ru	none	
playno1.com	nil
keywordspy.com	nil
automart.co.za	nil
51nb.com	nil
superherohype.com	nil
jacquieetmicheltv2.net	nil
liftable.com	nil
dateforsexymoments.com	nil
aldoshoes.com	nil
maxpreps.com	nil
bose.com	nil
cairokora.com	nil
ssense.com	none	self
ato.gov.au	nil
esprit-online-shop.com	nil
humanservices.gov.au	nil
rojadirecta.eu	nil
porn.es	nil
themetapicture.com	nil
edaily.co.kr	nil
cool18.com	nil
nld.com.vn	nil
infoescola.com	nil
sdsu.edu	nil
limango.de	nil
lmgtfy.com	invalid
hide.me	nil
xxl-rabatte.de	nil
libertyexpress.com	nil
ba.gov.br	nil
topfo.com	nil
cloudtime.to	nil
stonybrook.edu	nil
naver.net	nil
gta5-mods.com	nil
selectgo.net	nil
kinogo.net	nil
turkcealtyazi.org	nil
missycoupons.com	nil
ziare.com	none	unknown:mihai@etop.ro
maxdome.de	nil
duniaku.net	nil
codyhouse.co	nil
anilinkz.tv	nil
globes.co.il	nil
girl.me	nil
vodafone.com.eg	nil
linkomanija.net	nil
yao.cl	nil
fapvidhd.com	nil
s7days.com	nil
aldaniti.net	none	
urbia.de	nil
rosegal.com	nil
fatosdesconhecidos.com.br	nil
excel-easy.com	nil
hellocoton.fr	nil
applesfera.com	nil
uncommongoods.com	nil
nepaliheadlines.com	nil
pmvf.net	nil
educity.cn	nil
bot.com.tw	nil
simplymarry.com	nil
kafeteria.pl	nil
shtyle.fm	nil
tax.gov.ir	nil
manoramanews.com	nil
guenstiger.de	nil
gamesgames.com	nil
trivago.it	nil
amateri.cz	nil
q--play.com	nil
matometanews.com	nil
tt1069.com	nil
polskieradio.pl	nil
sportzwiki.com	nil
passeportsante.net	nil
kemdikbud.go.id	nil
xxxmomtube.com	nil
matome-plus.net	nil
radioshack.com	nil
myview.com	nil
quickbase.com	nil
espnfcasia.com	nil
ucsf.edu	nil
connexus.com	nil
ahlalhdeeth.com	nil
canoe.ca	nil
pb.gov.br	nil
iceporn.com	nil
0427d7.se	nil
realgfporn.com	nil
zouba.cn	nil
groupon.com.br	reject	agari,self
larazon.es	nil
gossip-tv.gr	nil
iitb.ac.in	nil
theme123.net	nil
breakingmuscle.com	nil
nameberry.com	nil
usenet.nl	nil
bluefly.com	nil
element14.com	nil
beauty.com	nil
thehealthsite.com	nil
tumi.com	nil
kingstars.ru	nil
realist.com	nil
tennis-warehouse.com	nil
garena.tw	nil
groupon.pl	none	self,agari
smartrecruiters.com	nil
ub.edu	nil
twitchy.com	nil
heydouga.com	nil
bankmillennium.pl	nil
mundotkm.com	nil
gensen2ch.com	nil
niazerooz.com	nil
9cache.com	nil
hostgator.com.br	invalid
chouti.com	nil
blabbermouth.net	nil
sparebank1.no	quarantine	self
enter.ru	nil
crazydomains.com.au	nil
istruzione.it	nil
sport5.co.il	nil
avforums.com	nil
fgov.be	nil
ekikara.jp	nil
360game.vn	nil
yithemes.com	nil
wptavern.com	nil
shopserve.jp	nil
forumactif.com	nil
sitescout.com	nil
inbound.org	nil
buzzsumo.com	nil
osaka.lg.jp	nil
ammonnews.net	nil
phun.org	nil
uwaterloo.ca	nil
amadeus.net	nil
salespider.com	none	self
diffen.com	nil
postto.me	nil
maturetube.com	nil
toto-dream.com	nil
hkbici.com	nil
4223.com	nil
leroymerlin.com.br	nil
random.org	nil
omniture.com	nil
cineplex.com	nil
todocoleccion.net	nil
bongdaplus.vn	nil
dereferer.org	nil
silverdaddies.com	nil
caradisiac.com	nil
zapmeta.com	nil
payoom.com	nil
bt.no	nil
flashresultats.fr	nil
dafiti.com.ar	nil
wizzed.com	nil
delcampe.net	nil
tff.org	nil
seowhy.com	nil
diapers.com	nil
figsoku.net	nil
raywenderlich.com	nil
worldtimebuddy.com	nil
ciwong.com	nil
lpoint.com	nil
revzilla.com	nil
freemalaysiatoday.com	nil
santander.cl	nil
yicheshi.com	nil
highsnobiety.com	nil
fsu.edu	nil
game.co.uk	nil
millionairesblueprint.co	nil
microsofttranslator.com	nil
financialpost.com	nil
jp-xvideos-av.com	nil
tokyodisneyresort.jp	nil
shmu.sk	nil
ibood.com	nil
orgasmatrix.com	nil
heyevent.com	nil
seekingarrangement.com	nil
n131adserv.com	nil
openculture.com	nil
interswitchng.com	nil
yescar.cn	nil
autobip.com	nil
epfindia.com	nil
fupa.net	nil
madewell.com	nil
demae-can.com	nil
x-rates.com	nil
lichess.org	invalid
questdiagnostics.com	nil
jetpack.wordpress.com	nil
getpebble.com	nil
frenchtorrentdb.com	nil
cncmax.cn	nil
xaluan.com	nil
sondakika.com	nil
iplocation.net	nil
uniauc.net	invalid
geny.com	nil
ouo.io	nil
peeplo.com	nil
kyobobook.co.kr	nil
zx555.net	nil
dartmouth.edu	nil
repai.com	nil
hrdepartment.com	nil
besttrendnews.net	nil
lineadirecta.com	nil
wiwo.de	nil
amadershomoys.com	nil
rarlab.com	nil
humoruniv.com	nil
tradesy.com	none	postmarkapp
myasiantv.com	nil
itpub.net	nil
dr.com.tr	nil
mangaku.web.id	nil
es.wix.com	nil
damai.cn	nil
freewebsubmission.com	nil
lyricsmania.com	nil
app-liv.jp	invalid
liuzhuni.com	nil
famousfootwear.com	nil
thegrommet.com	nil
songsterr.com	nil
blogg.no	nil
rosbalt.ru	nil
idiva.com	nil
cguwan.com	nil
shablol.com	nil
sportsblog.com	nil
mywebgrocer.com	nil
aesoponline.com	nil
freebeacon.com	nil
netwerk24.com	nil
phandroid.com	nil
tomsguide.fr	nil
almashhad-alyemeni.com	nil
elaph.com	nil
deal.by	nil
nist.gov	nil
reason.com	nil
smotrisport.tv	nil
diepresse.com	nil
vno.co.kr	nil
ekskluziva.ba	nil
bradesconetempresa.b.br	nil
